date,state,positive,negative,pending,hospitalizedCurrently,inIcuCurrently,onVentilatorCurrently,recovered,dateChecked,death,total,totalTestResults,posNeg,fips,deathIncrease,hospitalizedIncrease,negativeIncrease,positiveIncrease,totalTestResultsIncrease
2020-03-06,AK,0,8,1,0,0,0,0,2020-03-06T21:00:00Z,0,9,8,8,02,0,0,0,0,0
2020-03-07,AK,0,12,2,0,0,0,0,2020-03-07T21:00:00Z,0,14,12,12,02,0,0,4,0,4
2020-03-08,AK,0,14,6,0,0,0,0,2020-03-08T20:00:00Z,0,20,14,14,02,0,0,2,0,2
2020-03-09,AK,0,23,9,0,0,0,0,2020-03-09T20:00:00Z,0,32,23,23,02,0,0,9,0,9
2020-03-10,AK,0,23,9,0,0,0,0,2020-03-10T20:00:00Z,0,32,23,23,02,0,0,0,0,0
2020-03-11,AK,0,46,14,0,0,0,0,2020-03-11T20:00:00Z,0,60,46,46,02,0,0,23,0,23
2020-03-12,AK,0,46,14,0,0,0,0,2020-03-12T20:00:00Z,0,60,46,46,02,0,0,0,0,0
2020-03-13,AK,1,59,0,0,0,0,0,2020-03-13T20:00:00Z,0,60,60,60,02,0,0,13,1,14
2020-03-14,AK,1,143,0,0,0,0,0,2020-03-14T20:00:00Z,0,144,144,144,02,0,0,84,0,84
2020-03-15,AK,1,143,0,0,0,0,0,2020-03-15T20:00:00Z,0,144,144,144,02,0,0,0,0,0
2020-03-16,AK,1,143,0,0,0,0,0,2020-03-16T20:00:00Z,0,144,144,144,02,0,0,0,0,0
2020-03-17,AK,3,334,0,0,0,0,0,2020-03-17T20:00:00Z,0,337,337,337,02,0,0,191,2,193
2020-03-18,AK,6,406,0,0,0,0,0,2020-03-18T20:00:00Z,0,412,412,412,02,0,0,72,3,75
2020-03-19,AK,6,432,0,0,0,0,0,2020-03-19T20:00:00Z,0,438,438,438,02,0,0,26,0,26
2020-03-20,AK,12,686,0,0,0,0,0,2020-03-20T20:00:00Z,0,698,698,698,02,0,0,254,6,260
2020-03-21,AK,14,758,0,0,0,0,0,2020-03-21T20:00:00Z,0,772,772,772,02,0,0,72,2,74
2020-03-22,AK,22,946,0,0,0,0,0,2020-03-22T20:00:00Z,0,968,968,968,02,0,0,188,8,196
2020-03-23,AK,22,946,0,0,0,0,0,2020-03-23T20:00:00Z,0,968,968,968,02,0,0,0,0,0
2020-03-24,AK,36,986,0,0,0,0,0,2020-03-24T20:00:00Z,0,1022,1022,1022,02,0,0,40,14,54
2020-03-25,AK,42,1649,0,0,0,0,0,2020-03-25T20:00:00Z,1,1691,1691,1691,02,1,1,663,6,669
2020-03-26,AK,59,1801,0,0,0,0,0,2020-03-26T20:00:00Z,1,1860,1860,1860,02,0,2,152,17,169
2020-03-27,AK,69,2319,13,0,0,0,0,2020-03-27T20:00:00Z,1,2401,2388,2388,02,0,0,518,10,528
2020-03-28,AK,85,2836,0,0,0,0,0,2020-03-28T20:00:00Z,2,2921,2921,2921,02,1,2,517,16,533
2020-03-29,AK,102,3232,0,0,0,0,0,2020-03-29T20:00:00Z,2,3334,3334,3334,02,0,1,396,17,413
2020-03-30,AK,114,3540,0,0,0,0,0,2020-03-30T20:00:00Z,3,3654,3654,3654,02,1,1,308,12,320
2020-03-31,AK,119,3594,0,0,0,0,0,2020-03-31T20:00:00Z,3,3713,3713,3713,02,0,0,54,5,59
2020-04-01,AK,133,4470,0,0,0,0,0,2020-04-01T20:00:00Z,3,4603,4603,4603,02,0,2,876,14,890
2020-04-02,AK,143,4879,0,0,0,0,0,2020-04-02T20:00:00Z,3,5022,5022,5022,02,0,0,409,10,419
2020-04-03,AK,157,5859,0,0,0,0,0,2020-04-03T20:00:00Z,3,6016,6016,6016,02,0,6,980,14,994
2020-04-04,AK,171,5869,0,0,0,0,0,2020-04-04T20:00:00Z,5,6040,6040,6040,02,2,1,10,14,24
2020-04-05,AK,185,6099,0,0,0,0,0,2020-04-05T20:00:00Z,6,6284,6284,6284,02,1,4,230,14,244
2020-04-06,AK,191,6692,0,0,0,0,0,2020-04-06T20:00:00Z,6,6883,6883,6883,02,0,3,593,6,599
2020-03-07,AL,0,0,0,0,0,0,0,2020-03-07T21:00:00Z,0,0,0,0,01,0,0,0,0,0
2020-03-08,AL,0,0,0,0,0,0,0,2020-03-08T20:00:00Z,0,0,0,0,01,0,0,0,0,0
2020-03-09,AL,0,0,0,0,0,0,0,2020-03-09T20:00:00Z,0,0,0,0,01,0,0,0,0,0
2020-03-10,AL,0,0,0,0,0,0,0,2020-03-10T20:00:00Z,0,0,0,0,01,0,0,0,0,0
2020-03-11,AL,0,10,0,0,0,0,0,2020-03-11T20:00:00Z,0,10,10,10,01,0,0,10,0,10
2020-03-12,AL,0,10,0,0,0,0,0,2020-03-12T20:00:00Z,0,10,10,10,01,0,0,0,0,0
2020-03-13,AL,1,11,0,0,0,0,0,2020-03-13T20:00:00Z,0,12,12,12,01,0,0,1,1,2
2020-03-14,AL,6,22,46,0,0,0,0,2020-03-14T20:00:00Z,0,74,28,28,01,0,0,11,5,16
2020-03-15,AL,12,28,46,0,0,0,0,2020-03-15T20:00:00Z,0,86,40,40,01,0,0,6,6,12
2020-03-16,AL,28,28,40,0,0,0,0,2020-03-16T20:00:00Z,0,96,56,56,01,0,0,0,16,16
2020-03-17,AL,36,28,0,0,0,0,0,2020-03-17T20:00:00Z,0,64,64,64,01,0,0,0,8,8
2020-03-18,AL,46,28,0,0,0,0,0,2020-03-18T20:00:00Z,0,74,74,74,01,0,0,0,10,10
2020-03-19,AL,68,28,0,0,0,0,0,2020-03-19T20:00:00Z,0,96,96,96,01,0,0,0,22,22
2020-03-20,AL,81,28,0,0,0,0,0,2020-03-20T20:00:00Z,0,109,109,109,01,0,0,0,13,13
2020-03-21,AL,124,28,0,0,0,0,0,2020-03-21T20:00:00Z,0,152,152,152,01,0,0,0,43,43
2020-03-22,AL,138,1464,0,0,0,0,0,2020-03-22T20:00:00Z,0,1602,1602,1602,01,0,0,1436,14,1450
2020-03-23,AL,167,1665,0,0,0,0,0,2020-03-23T20:00:00Z,0,1832,1832,1832,01,0,0,201,29,230
2020-03-24,AL,215,2106,0,0,0,0,0,2020-03-24T20:00:00Z,0,2321,2321,2321,01,0,0,441,48,489
2020-03-25,AL,283,2529,0,0,0,0,0,2020-03-25T20:00:00Z,0,2812,2812,2812,01,0,0,423,68,491
2020-03-26,AL,506,3593,0,0,0,0,0,2020-03-26T20:00:00Z,1,4099,4099,4099,01,1,0,1064,223,1287
2020-03-27,AL,587,4184,0,0,0,0,0,2020-03-27T20:00:00Z,3,4771,4771,4771,01,2,0,591,81,672
2020-03-28,AL,696,4184,0,0,0,0,0,2020-03-28T20:00:00Z,3,4880,4880,4880,01,0,0,0,109,109
2020-03-29,AL,806,4184,0,0,0,0,0,2020-03-29T20:00:00Z,4,4990,4990,4990,01,1,0,0,110,110
2020-03-30,AL,859,5694,0,0,0,0,0,2020-03-30T20:00:00Z,6,6553,6553,6553,01,2,0,1510,53,1563
2020-03-31,AL,981,6298,0,0,0,0,0,2020-03-31T20:00:00Z,13,7279,7279,7279,01,7,0,604,122,726
2020-04-01,AL,1077,6697,0,0,0,0,0,2020-04-01T20:00:00Z,26,7774,7774,7774,01,13,0,399,96,495
2020-04-02,AL,1233,7503,0,0,0,0,0,2020-04-02T20:00:00Z,32,8736,8736,8736,01,6,0,806,156,962
2020-04-03,AL,1432,8187,0,0,0,0,0,2020-04-03T20:00:00Z,35,9619,9619,9619,01,3,0,684,199,883
2020-04-04,AL,1580,9273,0,0,0,0,0,2020-04-04T20:00:00Z,43,10853,10853,10853,01,8,212,1086,148,1234
2020-04-05,AL,1796,11282,0,0,0,0,0,2020-04-05T20:00:00Z,45,13078,13078,13078,01,2,19,2009,216,2225
2020-04-06,AL,1968,12797,0,0,0,0,0,2020-04-06T20:00:00Z,50,14765,14765,14765,01,5,9,1515,172,1687
2020-03-06,AR,0,6,0,0,0,0,0,2020-03-06T21:00:00Z,0,6,6,6,05,0,0,0,0,0
2020-03-07,AR,0,6,0,0,0,0,0,2020-03-07T21:00:00Z,0,6,6,6,05,0,0,0,0,0
2020-03-08,AR,0,6,0,0,0,0,0,2020-03-08T20:00:00Z,0,6,6,6,05,0,0,0,0,0
2020-03-09,AR,0,12,0,0,0,0,0,2020-03-09T20:00:00Z,0,12,12,12,05,0,0,6,0,6
2020-03-10,AR,0,12,3,0,0,0,0,2020-03-10T20:00:00Z,0,15,12,12,05,0,0,0,0,0
2020-03-11,AR,0,12,14,0,0,0,0,2020-03-11T20:00:00Z,0,26,12,12,05,0,0,0,0,0
2020-03-12,AR,6,24,20,0,0,0,0,2020-03-12T20:00:00Z,0,50,30,30,05,0,0,12,6,18
2020-03-13,AR,9,30,22,0,0,0,0,2020-03-13T20:00:00Z,0,61,39,39,05,0,0,6,3,9
2020-03-14,AR,12,65,26,0,0,0,0,2020-03-14T20:00:00Z,0,103,77,77,05,0,0,35,3,38
2020-03-15,AR,16,103,30,0,0,0,0,2020-03-15T20:00:00Z,0,149,119,119,05,0,0,38,4,42
2020-03-16,AR,22,132,14,0,0,0,0,2020-03-16T20:00:00Z,0,168,154,154,05,0,0,29,6,35
2020-03-17,AR,22,197,41,0,0,0,0,2020-03-17T20:00:00Z,0,260,219,219,05,0,0,65,0,65
2020-03-18,AR,33,236,50,0,0,0,0,2020-03-18T20:00:00Z,0,319,269,269,05,0,0,39,11,50
2020-03-19,AR,46,310,113,0,0,0,0,2020-03-19T20:00:00Z,0,469,356,356,05,0,0,74,13,87
2020-03-20,AR,96,351,203,0,0,0,0,2020-03-20T20:00:00Z,0,650,447,447,05,0,0,41,50,91
2020-03-21,AR,118,567,154,0,0,0,0,2020-03-21T20:00:00Z,0,839,685,685,05,0,0,216,22,238
2020-03-22,AR,165,711,119,0,0,0,0,2020-03-22T20:00:00Z,0,995,876,876,05,0,13,144,47,191
2020-03-23,AR,174,906,0,0,0,0,0,2020-03-23T20:00:00Z,0,1080,1080,1080,05,0,0,195,9,204
2020-03-24,AR,218,947,0,0,0,0,0,2020-03-24T20:00:00Z,0,1165,1165,1165,05,0,9,41,44,85
2020-03-25,AR,280,1437,0,0,0,4,11,2020-03-25T20:00:00Z,2,1717,1717,1717,05,2,0,490,62,552
2020-03-26,AR,335,1504,0,0,0,13,13,2020-03-26T20:00:00Z,3,1839,1839,1839,05,1,19,67,55,122
2020-03-27,AR,381,1545,0,48,0,17,19,2020-03-27T20:00:00Z,3,1926,1926,1926,05,0,7,41,46,87
2020-03-28,AR,404,2938,0,48,0,17,24,2020-03-28T20:00:00Z,5,3342,3342,3342,05,2,0,1393,23,1416
2020-03-29,AR,426,3027,0,43,0,16,28,2020-03-29T20:00:00Z,6,3453,3453,3453,05,1,0,89,22,111
2020-03-30,AR,473,5262,0,62,0,21,29,2020-03-30T20:00:00Z,7,5735,5735,5735,05,1,14,2235,47,2282
2020-03-31,AR,523,5959,0,64,0,23,35,2020-03-31T20:00:00Z,8,6482,6482,6482,05,1,2,697,50,747
2020-04-01,AR,584,7354,0,56,0,25,42,2020-04-01T20:00:00Z,10,7938,7938,7938,05,2,26,1395,61,1456
2020-04-02,AR,643,7880,0,66,0,23,47,2020-04-02T20:00:00Z,12,8523,8523,8523,05,2,0,526,59,585
2020-04-03,AR,704,8995,0,71,0,26,60,2020-04-03T20:00:00Z,12,9699,9699,9699,05,0,0,1115,61,1176
2020-04-04,AR,743,9627,0,72,0,23,79,2020-04-04T20:00:00Z,14,10370,10370,10370,05,2,0,632,39,671
2020-04-05,AR,830,10412,0,67,0,27,97,2020-04-05T20:00:00Z,16,11242,11242,11242,05,2,130,785,87,872
2020-04-06,AR,875,11970,0,74,0,22,102,2020-04-06T20:00:00Z,16,12845,12845,12845,05,0,0,1558,45,1603
2020-03-16,AS,0,0,0,0,0,0,0,2020-03-16T20:00:00Z,0,0,0,0,60,0,0,0,0,0
2020-03-17,AS,0,0,0,0,0,0,0,2020-03-17T20:00:00Z,0,0,0,0,60,0,0,0,0,0
2020-03-18,AS,0,0,0,0,0,0,0,2020-03-18T20:00:00Z,0,0,0,0,60,0,0,0,0,0
2020-03-19,AS,0,0,0,0,0,0,0,2020-03-19T20:00:00Z,0,0,0,0,60,0,0,0,0,0
2020-03-20,AS,0,0,0,0,0,0,0,2020-03-20T20:00:00Z,0,0,0,0,60,0,0,0,0,0
2020-03-21,AS,0,0,0,0,0,0,0,2020-03-21T20:00:00Z,0,0,0,0,60,0,0,0,0,0
2020-03-22,AS,0,0,0,0,0,0,0,2020-03-22T20:00:00Z,0,0,0,0,60,0,0,0,0,0
2020-03-23,AS,0,0,0,0,0,0,0,2020-03-23T20:00:00Z,0,0,0,0,60,0,0,0,0,0
2020-03-24,AS,0,0,0,0,0,0,0,2020-03-24T20:00:00Z,0,0,0,0,60,0,0,0,0,0
2020-03-25,AS,0,0,0,0,0,0,0,2020-03-25T20:00:00Z,0,0,0,0,60,0,0,0,0,0
2020-03-26,AS,0,0,0,0,0,0,0,2020-03-26T20:00:00Z,0,0,0,0,60,0,0,0,0,0
2020-03-27,AS,0,0,0,0,0,0,0,2020-03-27T20:00:00Z,0,0,0,0,60,0,0,0,0,0
2020-03-28,AS,0,0,0,0,0,0,0,2020-03-28T20:00:00Z,0,0,0,0,60,0,0,0,0,0
2020-03-29,AS,0,0,0,0,0,0,0,2020-03-29T20:00:00Z,0,0,0,0,60,0,0,0,0,0
2020-03-30,AS,0,0,0,0,0,0,0,2020-03-30T20:00:00Z,0,0,0,0,60,0,0,0,0,0
2020-03-31,AS,0,3,2,0,0,0,0,2020-03-31T20:00:00Z,0,5,3,3,60,0,0,3,0,3
2020-04-01,AS,0,20,6,0,0,0,0,2020-04-01T20:00:00Z,0,26,20,20,60,0,0,17,0,17
2020-04-02,AS,0,20,6,0,0,0,0,2020-04-02T20:00:00Z,0,26,20,20,60,0,0,0,0,0
2020-04-03,AS,0,20,6,0,0,0,0,2020-04-03T20:00:00Z,0,26,20,20,60,0,0,0,0,0
2020-04-04,AS,0,20,6,0,0,0,0,2020-04-04T20:00:00Z,0,26,20,20,60,0,0,0,0,0
2020-04-05,AS,0,20,6,0,0,0,0,2020-04-05T20:00:00Z,0,26,20,20,60,0,0,0,0,0
2020-04-06,AS,0,20,11,0,0,0,0,2020-04-06T20:00:00Z,0,31,20,20,60,0,0,0,0,0
2020-03-04,AZ,2,27,5,0,0,0,0,2020-03-04T21:00:00Z,0,34,29,29,04,0,0,0,0,0
2020-03-05,AZ,2,28,6,0,0,0,0,2020-03-05T21:00:00Z,0,36,30,30,04,0,0,1,0,1
2020-03-06,AZ,3,33,15,0,0,0,0,2020-03-06T21:00:00Z,0,51,36,36,04,0,0,5,1,6
2020-03-07,AZ,5,44,7,0,0,0,0,2020-03-07T21:00:00Z,0,56,49,49,04,0,0,11,2,13
2020-03-08,AZ,5,44,7,0,0,0,0,2020-03-08T20:00:00Z,0,56,49,49,04,0,0,0,0,0
2020-03-09,AZ,5,44,7,0,0,0,0,2020-03-09T20:00:00Z,0,56,49,49,04,0,0,0,0,0
2020-03-10,AZ,6,51,27,0,0,0,0,2020-03-10T20:00:00Z,0,84,57,57,04,0,0,7,1,8
2020-03-11,AZ,9,59,32,0,0,0,0,2020-03-11T20:00:00Z,0,100,68,68,04,0,0,8,3,11
2020-03-12,AZ,9,82,24,0,0,0,0,2020-03-12T20:00:00Z,0,115,91,91,04,0,0,23,0,23
2020-03-13,AZ,9,94,40,0,0,0,0,2020-03-13T20:00:00Z,0,143,103,103,04,0,0,12,0,12
2020-03-14,AZ,12,121,50,0,0,0,0,2020-03-14T20:00:00Z,0,183,133,133,04,0,0,27,3,30
2020-03-15,AZ,12,121,50,0,0,0,0,2020-03-15T20:00:00Z,0,183,133,133,04,0,0,0,0,0
2020-03-16,AZ,18,125,63,0,0,0,0,2020-03-16T20:00:00Z,0,206,143,143,04,0,0,4,6,10
2020-03-17,AZ,20,142,66,0,0,0,0,2020-03-17T20:00:00Z,0,228,162,162,04,0,0,17,2,19
2020-03-18,AZ,28,148,102,0,0,0,0,2020-03-18T20:00:00Z,0,278,176,176,04,0,0,6,8,14
2020-03-19,AZ,44,175,130,0,0,0,0,2020-03-19T20:00:00Z,0,349,219,219,04,0,0,27,16,43
2020-03-20,AZ,65,211,101,0,0,0,0,2020-03-20T20:00:00Z,0,377,276,276,04,0,0,36,21,57
2020-03-21,AZ,104,240,122,0,0,0,0,2020-03-21T20:00:00Z,1,466,344,344,04,1,0,29,39,68
2020-03-22,AZ,152,282,87,0,0,0,0,2020-03-22T20:00:00Z,2,521,434,434,04,1,0,42,48,90
2020-03-23,AZ,265,309,6,0,0,0,0,2020-03-23T20:00:00Z,2,580,574,574,04,0,0,27,113,140
2020-03-24,AZ,357,313,22,0,0,0,0,2020-03-24T20:00:00Z,5,692,670,670,04,3,8,4,92,96
2020-03-25,AZ,450,323,53,0,0,0,0,2020-03-25T20:00:00Z,6,826,773,773,04,1,0,10,93,103
2020-03-26,AZ,577,347,33,0,0,0,0,2020-03-26T20:00:00Z,8,957,924,924,04,2,58,24,127,151
2020-03-27,AZ,736,7455,30,0,0,0,0,2020-03-27T20:00:00Z,13,8221,8191,8191,04,5,0,7108,159,7267
2020-03-28,AZ,873,7455,21,0,0,0,0,2020-03-28T20:00:00Z,15,8349,8328,8328,04,2,0,0,137,137
2020-03-29,AZ,919,12953,0,0,0,0,0,2020-03-29T20:00:00Z,17,13872,13872,13872,04,2,78,5498,46,5544
2020-03-30,AZ,1157,15602,0,0,0,0,0,2020-03-30T20:00:00Z,20,16759,16759,16759,04,3,0,2649,238,2887
2020-03-31,AZ,1289,18082,0,0,0,0,0,2020-03-31T20:00:00Z,24,19371,19371,19371,04,4,0,2480,132,2612
2020-04-01,AZ,1413,19645,0,0,0,0,0,2020-04-01T20:00:00Z,29,21058,21058,21058,04,5,71,1563,124,1687
2020-04-02,AZ,1598,21111,0,0,0,0,0,2020-04-02T20:00:00Z,32,22709,22709,22709,04,3,79,1466,185,1651
2020-04-03,AZ,1769,22904,0,0,0,0,0,2020-04-03T20:00:00Z,41,24673,24673,24673,04,9,21,1793,171,1964
2020-04-04,AZ,2019,25141,0,0,0,0,0,2020-04-04T20:00:00Z,52,27160,27160,27160,04,11,48,2237,250,2487
2020-04-05,AZ,2269,25141,0,0,0,0,0,2020-04-05T20:00:00Z,64,27410,27410,27410,04,12,13,0,250,250
2020-04-06,AZ,2456,30078,0,0,0,0,0,2020-04-06T20:00:00Z,65,32534,32534,32534,04,1,15,4937,187,5124
2020-03-04,CA,53,462,0,0,0,0,0,2020-03-04T21:00:00Z,0,515,515,515,06,0,0,0,0,0
2020-03-05,CA,53,462,0,0,0,0,0,2020-03-05T21:00:00Z,0,515,515,515,06,0,0,0,0,0
2020-03-06,CA,60,462,0,0,0,0,0,2020-03-06T21:00:00Z,0,522,522,522,06,0,0,0,7,7
2020-03-07,CA,69,462,0,0,0,0,0,2020-03-07T21:00:00Z,0,531,531,531,06,0,0,0,9,9
2020-03-08,CA,88,462,0,0,0,0,0,2020-03-08T20:00:00Z,0,550,550,550,06,0,0,0,19,19
2020-03-09,CA,114,690,0,0,0,0,0,2020-03-09T20:00:00Z,0,804,804,804,06,0,0,228,26,254
2020-03-10,CA,133,690,0,0,0,0,0,2020-03-10T20:00:00Z,0,823,823,823,06,0,0,0,19,19
2020-03-11,CA,157,916,0,0,0,0,0,2020-03-11T20:00:00Z,0,1073,1073,1073,06,0,0,226,24,250
2020-03-12,CA,202,916,0,0,0,0,0,2020-03-12T20:00:00Z,4,1118,1118,1118,06,4,0,0,45,45
2020-03-13,CA,202,916,0,0,0,0,0,2020-03-13T20:00:00Z,4,1118,1118,1118,06,0,0,0,0,0
2020-03-14,CA,252,916,0,0,0,0,0,2020-03-14T20:00:00Z,5,1168,1168,1168,06,1,0,0,50,50
2020-03-15,CA,293,916,0,0,0,0,0,2020-03-15T20:00:00Z,5,1209,1209,1209,06,0,0,0,41,41
2020-03-16,CA,335,7981,0,0,0,0,0,2020-03-16T20:00:00Z,6,8316,8316,8316,06,1,0,7065,42,7107
2020-03-17,CA,483,7981,0,0,0,0,0,2020-03-17T20:00:00Z,11,8464,8464,8464,06,5,0,0,148,148
2020-03-18,CA,611,7981,0,0,0,0,0,2020-03-18T20:00:00Z,13,8592,8592,8592,06,2,0,0,128,128
2020-03-19,CA,924,8787,0,0,0,0,0,2020-03-19T20:00:00Z,18,9711,9711,9711,06,5,0,806,313,1119
2020-03-20,CA,1063,10424,0,0,0,0,0,2020-03-20T20:00:00Z,20,11487,11487,11487,06,2,0,1637,139,1776
2020-03-21,CA,1279,11249,0,0,0,0,0,2020-03-21T20:00:00Z,24,12528,12528,12528,06,4,0,825,216,1041
2020-03-22,CA,1536,11304,0,0,0,0,0,2020-03-22T20:00:00Z,27,12840,12840,12840,06,3,0,55,257,312
2020-03-23,CA,1733,12567,12100,0,0,0,0,2020-03-23T20:00:00Z,27,26400,14300,14300,06,0,0,1263,197,1460
2020-03-24,CA,2102,13452,12100,0,0,0,0,2020-03-24T20:00:00Z,40,27654,15554,15554,06,13,0,885,369,1254
2020-03-25,CA,2355,15921,48600,0,0,0,0,2020-03-25T20:00:00Z,53,66876,18276,18276,06,13,0,2469,253,2722
2020-03-26,CA,3006,17380,57400,0,0,0,0,2020-03-26T20:00:00Z,65,77786,20386,20386,06,12,0,1459,651,2110
2020-03-27,CA,3879,17380,57400,746,200,0,0,2020-03-27T20:00:00Z,78,78659,21259,21259,06,13,746,0,873,873
2020-03-28,CA,4643,20549,64400,1034,410,0,0,2020-03-28T20:00:00Z,101,89592,25192,25192,06,23,288,3169,764,3933
2020-03-29,CA,5708,20549,64400,1034,410,0,0,2020-03-29T20:00:00Z,123,90657,26257,26257,06,22,0,0,1065,1065
2020-03-30,CA,6447,20549,64400,1432,597,0,0,2020-03-30T20:00:00Z,133,91396,26996,26996,06,10,398,0,739,739
2020-03-31,CA,7482,21772,57400,1617,657,0,0,2020-03-31T20:00:00Z,153,86654,29254,29254,06,20,185,1223,1035,2258
2020-04-01,CA,8155,21772,57400,1855,774,0,0,2020-04-01T20:00:00Z,171,87327,29927,29927,06,18,238,0,673,673
2020-04-02,CA,9191,23809,59500,1922,816,0,0,2020-04-02T20:00:00Z,203,92500,33000,33000,06,32,0,2037,1036,3073
2020-04-03,CA,10701,24599,59500,2188,901,0,0,2020-04-03T20:00:00Z,237,94800,35300,35300,06,34,0,790,1510,2300
2020-04-04,CA,12026,101674,13000,2300,1008,0,0,2020-04-04T20:00:00Z,276,126700,113700,113700,06,39,0,77075,1325,78400
2020-04-05,CA,13438,103095,15000,2398,1040,0,0,2020-04-05T20:00:00Z,319,131533,116533,116533,06,43,0,1421,1412,2833
2020-04-06,CA,14336,103095,15000,2509,1085,0,0,2020-04-06T20:00:00Z,343,132431,117431,117431,06,24,0,0,898,898
2020-03-05,CO,0,19,21,0,0,0,0,2020-03-05T21:00:00Z,0,40,19,19,08,0,0,0,0,0
2020-03-06,CO,2,46,30,0,0,0,0,2020-03-06T21:00:00Z,0,78,48,48,08,0,0,27,2,29
2020-03-07,CO,8,55,69,0,0,0,0,2020-03-07T21:00:00Z,0,132,63,63,08,0,0,9,6,15
2020-03-08,CO,8,104,0,0,0,0,0,2020-03-08T20:00:00Z,0,112,112,112,08,0,0,49,0,49
2020-03-09,CO,9,133,0,0,0,0,0,2020-03-09T20:00:00Z,0,142,142,142,08,0,0,29,1,30
2020-03-10,CO,12,142,1,0,0,0,0,2020-03-10T20:00:00Z,0,155,154,154,08,0,0,9,3,12
2020-03-11,CO,28,251,0,0,0,0,0,2020-03-11T20:00:00Z,0,279,279,279,08,0,0,109,16,125
2020-03-12,CO,45,298,0,0,0,0,0,2020-03-12T20:00:00Z,0,343,343,343,08,0,0,47,17,64
2020-03-13,CO,72,524,0,0,0,0,0,2020-03-13T20:00:00Z,0,596,596,596,08,0,0,226,27,253
2020-03-14,CO,101,610,0,0,0,0,0,2020-03-14T20:00:00Z,1,711,711,711,08,1,0,86,29,115
2020-03-15,CO,131,627,0,0,0,0,0,2020-03-15T20:00:00Z,1,758,758,758,08,0,0,17,30,47
2020-03-16,CO,131,627,0,0,0,0,0,2020-03-16T20:00:00Z,1,758,758,758,08,0,0,0,0,0
2020-03-17,CO,160,1056,0,0,0,0,0,2020-03-17T20:00:00Z,1,1216,1216,1216,08,0,0,429,29,458
2020-03-18,CO,183,1617,0,0,0,0,0,2020-03-18T20:00:00Z,2,1800,1800,1800,08,1,0,561,23,584
2020-03-19,CO,216,2112,0,0,0,0,0,2020-03-19T20:00:00Z,2,2328,2328,2328,08,0,0,495,33,528
2020-03-20,CO,277,2675,0,0,0,0,0,2020-03-20T20:00:00Z,3,2952,2952,2952,08,1,0,563,61,624
2020-03-21,CO,363,3317,0,0,0,0,0,2020-03-21T20:00:00Z,4,3680,3680,3680,08,1,44,642,86,728
2020-03-22,CO,475,4075,0,0,0,0,0,2020-03-22T20:00:00Z,5,4550,4550,4550,08,1,5,758,112,870
2020-03-23,CO,591,4845,0,0,0,0,0,2020-03-23T20:00:00Z,6,5436,5436,5436,08,1,9,770,116,886
2020-03-24,CO,720,5504,0,0,0,0,0,2020-03-24T20:00:00Z,7,6224,6224,6224,08,1,14,659,129,788
2020-03-25,CO,912,6789,0,0,0,0,0,2020-03-25T20:00:00Z,11,7701,7701,7701,08,4,12,1285,192,1477
2020-03-26,CO,1086,6978,0,0,0,0,0,2020-03-26T20:00:00Z,19,8064,8064,8064,08,8,64,189,174,363
2020-03-27,CO,1430,8692,0,0,0,0,0,2020-03-27T20:00:00Z,24,10122,10122,10122,08,5,36,1714,344,2058
2020-03-28,CO,1734,9942,0,0,0,0,0,2020-03-28T20:00:00Z,31,11676,11676,11676,08,7,55,1250,304,1554
2020-03-29,CO,2061,11215,0,0,0,0,0,2020-03-29T20:00:00Z,44,13276,13276,13276,08,13,35,1273,327,1600
2020-03-30,CO,2627,12737,0,0,0,0,0,2020-03-30T20:00:00Z,51,15364,15364,15364,08,7,140,1522,566,2088
2020-03-31,CO,2627,12737,0,0,0,0,0,2020-03-31T20:00:00Z,51,15364,15364,15364,08,0,0,0,0,0
2020-04-01,CO,2966,13883,0,0,0,0,0,2020-04-01T20:00:00Z,69,16849,16849,16849,08,18,95,1146,339,1485
2020-04-02,CO,3342,15303,0,0,0,0,0,2020-04-02T20:00:00Z,80,18645,18645,18645,08,11,111,1420,376,1796
2020-04-03,CO,3728,16683,0,0,0,0,0,2020-04-03T20:00:00Z,97,20411,20411,20411,08,17,90,1380,386,1766
2020-04-04,CO,4173,17898,0,0,0,0,0,2020-04-04T20:00:00Z,111,22071,22071,22071,08,14,113,1215,445,1660
2020-04-05,CO,4565,19335,0,0,0,0,0,2020-04-05T20:00:00Z,126,23900,23900,23900,08,15,52,1437,392,1829
2020-04-06,CO,4950,20823,0,0,0,0,0,2020-04-06T20:00:00Z,140,25773,25773,25773,08,14,49,1488,385,1873
2020-03-07,CT,0,0,0,0,0,0,0,2020-03-07T21:00:00Z,0,0,0,0,09,0,0,0,0,0
2020-03-08,CT,1,29,8,0,0,0,0,2020-03-08T20:00:00Z,0,38,30,30,09,0,0,29,1,30
2020-03-09,CT,1,46,0,0,0,0,0,2020-03-09T20:00:00Z,0,47,47,47,09,0,0,17,0,17
2020-03-10,CT,2,54,0,0,0,0,0,2020-03-10T20:00:00Z,0,56,56,56,09,0,0,8,1,9
2020-03-11,CT,3,71,0,0,0,0,0,2020-03-11T20:00:00Z,0,74,74,74,09,0,0,17,1,18
2020-03-12,CT,6,89,0,0,0,0,0,2020-03-12T20:00:00Z,0,95,95,95,09,0,0,18,3,21
2020-03-13,CT,6,99,0,0,0,0,0,2020-03-13T20:00:00Z,0,105,105,105,09,0,0,10,0,10
2020-03-14,CT,11,125,0,0,0,0,0,2020-03-14T20:00:00Z,0,136,136,136,09,0,0,26,5,31
2020-03-15,CT,20,125,0,0,0,0,0,2020-03-15T20:00:00Z,0,145,145,145,09,0,0,0,9,9
2020-03-16,CT,26,125,0,0,0,0,0,2020-03-16T20:00:00Z,0,151,151,151,09,0,0,0,6,6
2020-03-17,CT,41,125,0,0,0,0,0,2020-03-17T20:00:00Z,0,166,166,166,09,0,0,0,15,15
2020-03-18,CT,68,125,0,0,0,0,0,2020-03-18T20:00:00Z,0,193,193,193,09,0,0,0,27,27
2020-03-19,CT,96,604,0,0,0,0,0,2020-03-19T20:00:00Z,1,700,700,700,09,1,0,479,28,507
2020-03-20,CT,194,604,0,0,0,0,0,2020-03-20T20:00:00Z,3,798,798,798,09,2,0,0,98,98
2020-03-21,CT,194,2106,0,0,0,0,0,2020-03-21T20:00:00Z,4,2300,2300,2300,09,1,0,1502,0,1502
2020-03-22,CT,223,2877,0,0,0,0,0,2020-03-22T20:00:00Z,5,3100,3100,3100,09,1,43,771,29,800
2020-03-23,CT,415,4085,0,0,0,0,0,2020-03-23T20:00:00Z,10,4500,4500,4500,09,5,11,1208,192,1400
2020-03-24,CT,618,4682,0,0,0,0,0,2020-03-24T20:00:00Z,12,5300,5300,5300,09,2,17,597,203,800
2020-03-25,CT,875,5023,0,0,0,0,0,2020-03-25T20:00:00Z,19,5898,5898,5898,09,7,42,341,257,598
2020-03-26,CT,1012,5625,0,0,0,0,0,2020-03-26T20:00:00Z,21,6637,6637,6637,09,2,12,602,137,739
2020-03-27,CT,1291,7109,0,0,0,0,0,2020-03-27T20:00:00Z,27,8400,8400,8400,09,6,48,1484,279,1763
2020-03-28,CT,1291,7109,0,0,0,0,0,2020-03-28T20:00:00Z,27,8400,8400,8400,09,0,0,0,0,0
2020-03-29,CT,1993,9907,0,0,0,0,0,2020-03-29T20:00:00Z,34,11900,11900,11900,09,7,231,2798,702,3500
2020-03-30,CT,2571,12029,0,517,0,0,0,2020-03-30T20:00:00Z,36,14600,14600,14600,09,2,113,2122,578,2700
2020-03-31,CT,3128,13029,0,608,0,0,0,2020-03-31T20:00:00Z,69,16157,16157,16157,09,33,91,1000,557,1557
2020-04-01,CT,3557,13043,0,766,0,0,0,2020-04-01T20:00:00Z,85,16600,16600,16600,09,16,158,14,429,443
2020-04-02,CT,3824,14476,0,827,0,0,0,2020-04-02T20:00:00Z,112,18300,18300,18300,09,27,0,1433,267,1700
2020-04-03,CT,4914,15101,0,909,0,0,0,2020-04-03T20:00:00Z,131,20015,20015,20015,09,19,0,625,1090,1715
2020-04-04,CT,5276,16753,0,1033,0,0,0,2020-04-04T20:00:00Z,165,22029,22029,22029,09,34,0,1652,362,2014
2020-04-05,CT,5675,17595,0,1142,0,0,0,2020-04-05T20:00:00Z,189,23270,23270,23270,09,24,0,842,399,1241
2020-04-06,CT,6906,19780,0,1221,0,0,0,2020-04-06T20:00:00Z,206,26686,26686,26686,09,17,0,2185,1231,3416
2020-03-05,DC,0,6,2,0,0,0,0,2020-03-05T21:00:00Z,0,8,6,6,11,0,0,0,0,0
2020-03-06,DC,0,8,1,0,0,0,0,2020-03-06T21:00:00Z,0,9,8,8,11,0,0,2,0,2
2020-03-07,DC,0,8,1,0,0,0,0,2020-03-07T21:00:00Z,0,9,8,8,11,0,0,0,0,0
2020-03-08,DC,1,10,0,0,0,0,0,2020-03-08T20:00:00Z,0,11,11,11,11,0,0,2,1,3
2020-03-09,DC,1,14,3,0,0,0,0,2020-03-09T20:00:00Z,0,18,15,15,11,0,0,4,0,4
2020-03-10,DC,5,17,2,0,0,0,0,2020-03-10T20:00:00Z,0,24,22,22,11,0,0,3,4,7
2020-03-11,DC,5,20,15,0,0,0,0,2020-03-11T20:00:00Z,0,40,25,25,11,0,0,3,0,3
2020-03-12,DC,10,20,0,0,0,0,0,2020-03-12T20:00:00Z,0,30,30,30,11,0,0,0,5,5
2020-03-13,DC,10,20,0,0,0,0,0,2020-03-13T20:00:00Z,0,30,30,30,11,0,0,0,0,0
2020-03-14,DC,10,49,10,0,0,0,0,2020-03-14T20:00:00Z,0,69,59,59,11,0,0,29,0,29
2020-03-15,DC,16,79,20,0,0,0,0,2020-03-15T20:00:00Z,0,115,95,95,11,0,0,30,6,36
2020-03-16,DC,17,96,7,0,0,0,0,2020-03-16T20:00:00Z,0,120,113,113,11,0,0,17,1,18
2020-03-17,DC,22,104,0,0,0,0,0,2020-03-17T20:00:00Z,0,126,126,126,11,0,0,8,5,13
2020-03-18,DC,31,138,1,0,0,0,0,2020-03-18T20:00:00Z,0,170,169,169,11,0,0,34,9,43
2020-03-19,DC,39,153,11,0,0,0,0,2020-03-19T20:00:00Z,0,203,192,192,11,0,0,15,8,23
2020-03-20,DC,71,501,1,0,0,0,0,2020-03-20T20:00:00Z,1,573,572,572,11,1,0,348,32,380
2020-03-21,DC,77,506,0,0,0,0,0,2020-03-21T20:00:00Z,1,583,583,583,11,0,0,5,6,11
2020-03-22,DC,98,957,0,0,0,0,0,2020-03-22T20:00:00Z,1,1055,1055,1055,11,0,0,451,21,472
2020-03-23,DC,116,1113,0,0,0,0,0,2020-03-23T20:00:00Z,2,1229,1229,1229,11,1,0,156,18,174
2020-03-24,DC,137,1195,2,0,0,0,0,2020-03-24T20:00:00Z,2,1334,1332,1332,11,0,0,82,21,103
2020-03-25,DC,183,1423,3,0,0,0,0,2020-03-25T20:00:00Z,2,1609,1606,1606,11,0,0,228,46,274
2020-03-26,DC,231,1626,1,0,0,0,21,2020-03-26T20:00:00Z,3,1858,1857,1857,11,1,0,203,48,251
2020-03-27,DC,267,1897,2,0,0,0,49,2020-03-27T20:00:00Z,3,2166,2164,2164,11,0,0,271,36,307
2020-03-28,DC,304,2211,1,0,0,0,51,2020-03-28T20:00:00Z,4,2516,2515,2515,11,1,0,314,37,351
2020-03-29,DC,342,2469,1,0,0,0,66,2020-03-29T20:00:00Z,5,2812,2811,2811,11,1,0,258,38,296
2020-03-30,DC,401,2682,2,0,0,193,106,2020-03-30T20:00:00Z,9,3085,3083,3083,11,4,0,213,59,272
2020-03-31,DC,495,3262,2,0,0,0,121,2020-03-31T20:00:00Z,9,3759,3757,3757,11,0,0,580,94,674
2020-04-01,DC,586,3262,2,0,0,0,142,2020-04-01T20:00:00Z,11,3850,3848,3848,11,2,0,0,91,91
2020-04-02,DC,653,4417,0,0,0,0,173,2020-04-02T20:00:00Z,12,5070,5070,5070,11,1,0,1155,67,1222
2020-04-03,DC,757,4827,0,0,0,0,206,2020-04-03T20:00:00Z,15,5584,5584,5584,11,3,0,410,104,514
2020-04-04,DC,902,5536,0,0,0,0,235,2020-04-04T20:00:00Z,21,6438,6438,6438,11,6,0,709,145,854
2020-04-05,DC,998,5836,0,0,0,0,258,2020-04-05T20:00:00Z,22,6834,6834,6834,11,1,0,300,96,396
2020-04-06,DC,1097,6356,0,0,0,0,287,2020-04-06T20:00:00Z,24,7453,7453,7453,11,2,0,520,99,619
2020-03-06,DE,0,10,0,0,0,0,0,2020-03-06T21:00:00Z,0,10,10,10,10,0,0,0,0,0
2020-03-07,DE,0,10,0,0,0,0,0,2020-03-07T21:00:00Z,0,10,10,10,10,0,0,0,0,0
2020-03-08,DE,0,10,0,0,0,0,0,2020-03-08T20:00:00Z,0,10,10,10,10,0,0,0,0,0
2020-03-09,DE,0,15,3,0,0,0,0,2020-03-09T20:00:00Z,0,18,15,15,10,0,0,5,0,5
2020-03-10,DE,0,17,3,0,0,0,0,2020-03-10T20:00:00Z,0,20,17,17,10,0,0,2,0,2
2020-03-11,DE,1,17,2,0,0,0,0,2020-03-11T20:00:00Z,0,20,18,18,10,0,0,0,1,1
2020-03-12,DE,4,23,14,0,0,0,0,2020-03-12T20:00:00Z,0,41,27,27,10,0,0,6,3,9
2020-03-13,DE,4,30,10,0,0,0,0,2020-03-13T20:00:00Z,0,44,34,34,10,0,0,7,0,7
2020-03-14,DE,6,36,32,0,0,0,0,2020-03-14T20:00:00Z,0,74,42,42,10,0,0,6,2,8
2020-03-15,DE,6,36,32,0,0,0,0,2020-03-15T20:00:00Z,0,74,42,42,10,0,0,0,0,0
2020-03-16,DE,8,36,32,0,0,0,0,2020-03-16T20:00:00Z,0,76,44,44,10,0,0,0,2,2
2020-03-17,DE,16,36,0,0,0,0,0,2020-03-17T20:00:00Z,0,52,52,52,10,0,0,0,8,8
2020-03-18,DE,25,36,0,0,0,0,0,2020-03-18T20:00:00Z,0,61,61,61,10,0,0,0,9,9
2020-03-19,DE,30,36,0,0,0,0,0,2020-03-19T20:00:00Z,0,66,66,66,10,0,0,0,5,5
2020-03-20,DE,38,36,0,0,0,0,0,2020-03-20T20:00:00Z,0,74,74,74,10,0,0,0,8,8
2020-03-21,DE,45,36,0,0,0,0,0,2020-03-21T20:00:00Z,0,81,81,81,10,0,0,0,7,7
2020-03-22,DE,56,36,0,0,0,0,0,2020-03-22T20:00:00Z,0,92,92,92,10,0,0,0,11,11
2020-03-23,DE,68,36,0,0,0,0,0,2020-03-23T20:00:00Z,0,104,104,104,10,0,0,0,12,12
2020-03-24,DE,91,36,0,0,0,0,0,2020-03-24T20:00:00Z,0,127,127,127,10,0,0,0,23,23
2020-03-25,DE,115,36,0,0,0,0,0,2020-03-25T20:00:00Z,0,151,151,151,10,0,11,0,24,24
2020-03-26,DE,130,36,0,0,0,0,4,2020-03-26T20:00:00Z,1,166,166,166,10,1,2,0,15,15
2020-03-27,DE,163,36,0,0,0,0,9,2020-03-27T20:00:00Z,2,199,199,199,10,1,2,0,33,33
2020-03-28,DE,214,36,0,0,0,0,9,2020-03-28T20:00:00Z,3,250,250,250,10,1,16,0,51,51
2020-03-29,DE,232,36,0,0,0,0,9,2020-03-29T20:00:00Z,6,268,268,268,10,3,2,0,18,18
2020-03-30,DE,264,2216,0,0,0,0,9,2020-03-30T20:00:00Z,6,2480,2480,2480,10,0,12,2180,32,2212
2020-03-31,DE,319,3696,0,57,0,0,22,2020-03-31T20:00:00Z,10,4015,4015,4015,10,4,19,1480,55,1535
2020-04-01,DE,368,4015,0,51,0,0,49,2020-04-01T20:00:00Z,11,4383,4383,4383,10,1,-7,319,49,368
2020-04-02,DE,393,4566,0,56,0,0,49,2020-04-02T20:00:00Z,12,4959,4959,4959,10,1,0,551,25,576
2020-04-03,DE,450,4995,0,63,0,0,71,2020-04-03T20:00:00Z,14,5445,5445,5445,10,2,0,429,57,486
2020-04-04,DE,593,5874,0,95,0,0,71,2020-04-04T20:00:00Z,14,6467,6467,6467,10,0,0,879,143,1022
2020-04-05,DE,673,6321,0,101,0,0,71,2020-04-05T20:00:00Z,14,6994,6994,6994,10,0,0,447,80,527
2020-04-06,DE,673,6321,0,101,0,0,71,2020-04-06T20:00:00Z,14,6994,6994,6994,10,0,0,0,0,0
2020-03-04,FL,2,24,16,0,0,0,0,2020-03-04T21:00:00Z,0,42,26,26,12,0,0,0,0,0
2020-03-05,FL,9,31,69,0,0,0,0,2020-03-05T21:00:00Z,0,109,40,40,12,0,0,7,7,14
2020-03-06,FL,9,55,51,0,0,0,0,2020-03-06T21:00:00Z,0,115,64,64,12,0,0,24,0,24
2020-03-07,FL,14,100,88,0,0,0,0,2020-03-07T21:00:00Z,0,202,114,114,12,0,0,45,5,50
2020-03-08,FL,17,118,108,0,0,0,0,2020-03-08T20:00:00Z,0,243,135,135,12,0,0,18,3,21
2020-03-09,FL,18,140,115,0,0,0,0,2020-03-09T20:00:00Z,0,273,158,158,12,0,0,22,1,23
2020-03-10,FL,19,222,155,0,0,0,0,2020-03-10T20:00:00Z,0,396,241,241,12,0,0,82,1,83
2020-03-11,FL,28,301,147,0,0,0,0,2020-03-11T20:00:00Z,2,476,329,329,12,2,0,79,9,88
2020-03-12,FL,32,301,147,0,0,0,0,2020-03-12T20:00:00Z,2,480,333,333,12,0,0,0,4,4
2020-03-13,FL,50,478,221,0,0,0,0,2020-03-13T20:00:00Z,2,749,528,528,12,0,0,177,18,195
2020-03-14,FL,77,478,221,0,0,0,0,2020-03-14T20:00:00Z,3,776,555,555,12,1,0,0,27,27
2020-03-15,FL,116,678,454,0,0,0,0,2020-03-15T20:00:00Z,4,1248,794,794,12,1,0,200,39,239
2020-03-16,FL,141,684,514,0,0,0,0,2020-03-16T20:00:00Z,4,1339,825,825,12,0,0,6,25,31
2020-03-17,FL,186,940,872,0,0,0,0,2020-03-17T20:00:00Z,6,1998,1126,1126,12,2,0,256,45,301
2020-03-18,FL,314,1225,954,0,0,0,0,2020-03-18T20:00:00Z,7,2493,1539,1539,12,1,0,285,128,413
2020-03-19,FL,390,1533,1019,0,0,0,0,2020-03-19T20:00:00Z,8,2942,1923,1923,12,1,0,308,76,384
2020-03-20,FL,520,1870,1026,0,0,0,0,2020-03-20T20:00:00Z,10,3416,2390,2390,12,2,0,337,130,467
2020-03-21,FL,658,6579,1002,0,0,0,0,2020-03-21T20:00:00Z,12,8239,7237,7237,12,2,158,4709,138,4847
2020-03-22,FL,830,7990,963,0,0,0,0,2020-03-22T20:00:00Z,13,9783,8820,8820,12,1,27,1411,172,1583
2020-03-23,FL,1171,11063,860,0,0,0,0,2020-03-23T20:00:00Z,14,13094,12234,12234,12,1,32,3073,341,3414
2020-03-24,FL,1412,13127,1008,0,0,0,0,2020-03-24T20:00:00Z,18,15547,14539,14539,12,4,42,2064,241,2305
2020-03-25,FL,1682,15374,1233,0,0,0,0,2020-03-25T20:00:00Z,22,18289,17056,17056,12,4,57,2247,270,2517
2020-03-26,FL,2355,23741,1443,0,0,0,0,2020-03-26T20:00:00Z,28,27539,26096,26096,12,6,90,8367,673,9040
2020-03-27,FL,2765,28186,1517,0,0,0,0,2020-03-27T20:00:00Z,34,32468,30951,30951,12,6,50,4445,410,4855
2020-03-28,FL,3763,35366,0,0,0,0,0,2020-03-28T20:00:00Z,54,39129,39129,39129,12,20,70,7180,998,8178
2020-03-29,FL,4246,39070,0,0,0,0,0,2020-03-29T20:00:00Z,56,43316,43316,43316,12,2,68,3704,483,4187
2020-03-30,FL,5473,48225,0,0,0,0,0,2020-03-30T20:00:00Z,63,53698,53698,53698,12,7,58,9155,1227,10382
2020-03-31,FL,6338,54285,1163,0,0,0,0,2020-03-31T20:00:00Z,77,61786,60623,60623,12,14,171,6060,865,6925
2020-04-01,FL,6955,59529,1235,0,0,0,0,2020-04-01T20:00:00Z,87,67719,66484,66484,12,10,126,5244,617,5861
2020-04-02,FL,8010,69286,1285,0,0,0,0,2020-04-02T20:00:00Z,128,78581,77296,77296,12,41,174,9757,1055,10812
2020-04-03,FL,9585,82137,1225,1215,0,0,0,2020-04-03T20:00:00Z,163,92947,91722,91722,12,35,164,12851,1575,14426
2020-04-04,FL,11111,90956,1281,0,0,0,0,2020-04-04T20:00:00Z,191,103348,102067,102067,12,28,175,8819,1526,10345
2020-04-05,FL,12151,101253,1129,0,0,0,0,2020-04-05T20:00:00Z,218,114533,113404,113404,12,27,110,10297,1040,11337
2020-04-06,FL,13324,109950,1142,0,0,0,0,2020-04-06T20:00:00Z,236,124416,123274,123274,12,18,110,8697,1173,9870
2020-03-04,GA,2,0,0,0,0,0,0,2020-03-04T21:00:00Z,0,2,2,2,13,0,0,0,0,0
2020-03-05,GA,2,0,0,0,0,0,0,2020-03-05T21:00:00Z,0,2,2,2,13,0,0,0,0,0
2020-03-06,GA,2,0,0,0,0,0,0,2020-03-06T21:00:00Z,0,2,2,2,13,0,0,0,0,0
2020-03-07,GA,6,0,0,0,0,0,0,2020-03-07T21:00:00Z,0,6,6,6,13,0,0,0,4,4
2020-03-08,GA,7,0,0,0,0,0,0,2020-03-08T20:00:00Z,0,7,7,7,13,0,0,0,1,1
2020-03-09,GA,12,0,0,0,0,0,0,2020-03-09T20:00:00Z,0,12,12,12,13,0,0,0,5,5
2020-03-10,GA,17,0,0,0,0,0,0,2020-03-10T20:00:00Z,0,17,17,17,13,0,0,0,5,5
2020-03-11,GA,22,0,0,0,0,0,0,2020-03-11T20:00:00Z,0,22,22,22,13,0,0,0,5,5
2020-03-12,GA,31,0,0,0,0,0,0,2020-03-12T20:00:00Z,0,31,31,31,13,0,0,0,9,9
2020-03-13,GA,42,0,0,0,0,0,0,2020-03-13T20:00:00Z,1,42,42,42,13,1,0,0,11,11
2020-03-14,GA,66,0,0,0,0,0,0,2020-03-14T20:00:00Z,1,66,66,66,13,0,0,0,24,24
2020-03-15,GA,99,0,0,0,0,0,0,2020-03-15T20:00:00Z,1,99,99,99,13,0,0,0,33,33
2020-03-16,GA,121,0,0,0,0,0,0,2020-03-16T20:00:00Z,1,121,121,121,13,0,0,0,22,22
2020-03-17,GA,146,0,0,0,0,0,0,2020-03-17T20:00:00Z,1,146,146,146,13,0,0,0,25,25
2020-03-18,GA,197,1311,0,0,0,0,0,2020-03-18T20:00:00Z,1,1508,1508,1508,13,0,0,1311,51,1362
2020-03-19,GA,287,1544,0,0,0,0,0,2020-03-19T20:00:00Z,10,1831,1831,1831,13,9,0,233,90,323
2020-03-20,GA,420,1966,0,0,0,0,0,2020-03-20T20:00:00Z,13,2386,2386,2386,13,3,0,422,133,555
2020-03-21,GA,507,2557,0,0,0,0,0,2020-03-21T20:00:00Z,14,3064,3064,3064,13,1,0,591,87,678
2020-03-22,GA,600,3420,0,0,0,0,0,2020-03-22T20:00:00Z,23,4020,4020,4020,13,9,0,863,93,956
2020-03-23,GA,772,4297,0,0,0,0,0,2020-03-23T20:00:00Z,25,5069,5069,5069,13,2,0,877,172,1049
2020-03-24,GA,1026,4458,0,0,0,0,0,2020-03-24T20:00:00Z,32,5484,5484,5484,13,7,0,161,254,415
2020-03-25,GA,1247,4932,0,0,0,0,0,2020-03-25T20:00:00Z,40,6179,6179,6179,13,8,394,474,221,695
2020-03-26,GA,1525,7401,0,0,0,0,0,2020-03-26T20:00:00Z,48,8926,8926,8926,13,8,79,2469,278,2747
2020-03-27,GA,2001,7864,0,0,0,0,0,2020-03-27T20:00:00Z,64,9865,9865,9865,13,16,93,463,476,939
2020-03-28,GA,2366,8685,0,0,0,0,0,2020-03-28T20:00:00Z,69,11051,11051,11051,13,5,51,821,365,1186
2020-03-29,GA,2651,9913,0,0,0,0,0,2020-03-29T20:00:00Z,80,12564,12564,12564,13,11,49,1228,285,1513
2020-03-30,GA,2809,9915,0,0,0,0,0,2020-03-30T20:00:00Z,87,12724,12724,12724,13,7,41,2,158,160
2020-03-31,GA,3929,12252,0,0,0,0,0,2020-03-31T20:00:00Z,111,16181,16181,16181,13,24,126,2337,1120,3457
2020-04-01,GA,4638,15688,0,0,0,0,0,2020-04-01T20:00:00Z,139,20326,20326,20326,13,28,119,3436,709,4145
2020-04-02,GA,5348,17609,0,0,0,0,0,2020-04-02T20:00:00Z,163,22957,22957,22957,13,24,104,1921,710,2631
2020-04-03,GA,5831,19434,0,0,0,0,0,2020-04-03T20:00:00Z,184,25265,25265,25265,13,21,102,1825,483,2308
2020-04-04,GA,6160,20134,0,0,0,0,0,2020-04-04T20:00:00Z,201,26294,26294,26294,13,17,81,700,329,1029
2020-04-05,GA,6647,21185,0,0,0,0,0,2020-04-05T20:00:00Z,211,27832,27832,27832,13,10,44,1051,487,1538
2020-04-06,GA,7314,32698,0,0,0,0,0,2020-04-06T20:00:00Z,229,40012,40012,40012,13,18,49,11513,667,12180
2020-03-16,GU,3,23,0,0,0,0,0,2020-03-16T20:00:00Z,0,26,26,26,66,0,0,0,0,0
2020-03-17,GU,5,41,0,0,0,0,0,2020-03-17T20:00:00Z,0,46,46,46,66,0,0,18,2,20
2020-03-18,GU,8,57,0,0,0,0,0,2020-03-18T20:00:00Z,0,65,65,65,66,0,0,16,3,19
2020-03-19,GU,12,69,0,0,0,0,0,2020-03-19T20:00:00Z,0,81,81,81,66,0,0,12,4,16
2020-03-20,GU,14,86,0,0,0,0,0,2020-03-20T20:00:00Z,0,100,100,100,66,0,0,17,2,19
2020-03-21,GU,15,108,0,0,0,0,0,2020-03-21T20:00:00Z,0,123,123,123,66,0,0,22,1,23
2020-03-22,GU,27,126,0,0,0,0,0,2020-03-22T20:00:00Z,1,153,153,153,66,1,0,18,12,30
2020-03-23,GU,29,161,0,0,0,0,0,2020-03-23T20:00:00Z,1,190,190,190,66,0,0,35,2,37
2020-03-24,GU,32,201,0,0,0,0,0,2020-03-24T20:00:00Z,1,233,233,233,66,0,5,40,3,43
2020-03-25,GU,37,233,0,0,0,0,0,2020-03-25T20:00:00Z,1,270,270,270,66,0,5,32,5,37
2020-03-26,GU,45,263,0,0,0,0,0,2020-03-26T20:00:00Z,1,308,308,308,66,0,1,30,8,38
2020-03-27,GU,51,299,0,0,0,0,0,2020-03-27T20:00:00Z,1,350,350,350,66,0,0,36,6,42
2020-03-28,GU,55,299,0,0,0,0,7,2020-03-28T20:00:00Z,1,354,354,354,66,0,4,0,4,4
2020-03-29,GU,56,334,0,0,0,0,7,2020-03-29T20:00:00Z,1,390,390,390,66,0,0,35,1,36
2020-03-30,GU,58,352,0,0,0,0,7,2020-03-30T20:00:00Z,1,410,410,410,66,0,4,18,2,20
2020-03-31,GU,69,371,0,0,0,0,7,2020-03-31T20:00:00Z,2,440,440,440,66,1,0,19,11,30
2020-04-01,GU,77,406,0,0,0,0,9,2020-04-01T20:00:00Z,3,483,483,483,66,1,0,35,8,43
2020-04-02,GU,82,442,0,0,0,0,12,2020-04-02T20:00:00Z,3,524,524,524,66,0,0,36,5,41
2020-04-03,GU,84,459,0,0,0,0,14,2020-04-03T20:00:00Z,4,543,543,543,66,1,12,17,2,19
2020-04-04,GU,93,472,0,0,0,0,20,2020-04-04T20:00:00Z,4,565,565,565,66,0,0,13,9,22
2020-04-05,GU,112,493,0,0,0,0,23,2020-04-05T20:00:00Z,4,605,605,605,66,0,0,21,19,40
2020-04-06,GU,113,505,0,0,0,0,25,2020-04-06T20:00:00Z,4,618,618,618,66,0,0,12,1,13
2020-03-07,HI,1,0,0,0,0,0,0,2020-03-07T21:00:00Z,0,1,1,1,15,0,0,0,0,0
2020-03-08,HI,1,0,0,0,0,0,0,2020-03-08T20:00:00Z,0,1,1,1,15,0,0,0,0,0
2020-03-09,HI,2,0,0,0,0,0,0,2020-03-09T20:00:00Z,0,2,2,2,15,0,0,0,1,1
2020-03-10,HI,2,0,0,0,0,0,0,2020-03-10T20:00:00Z,0,2,2,2,15,0,0,0,0,0
2020-03-11,HI,2,0,0,0,0,0,0,2020-03-11T20:00:00Z,0,2,2,2,15,0,0,0,0,0
2020-03-12,HI,2,0,0,0,0,0,0,2020-03-12T20:00:00Z,0,2,2,2,15,0,0,0,0,0
2020-03-13,HI,2,0,0,0,0,0,0,2020-03-13T20:00:00Z,0,2,2,2,15,0,0,0,0,0
2020-03-14,HI,2,0,0,0,0,0,0,2020-03-14T20:00:00Z,0,2,2,2,15,0,0,0,0,0
2020-03-15,HI,2,0,0,0,0,0,0,2020-03-15T20:00:00Z,0,2,2,2,15,0,0,0,0,0
2020-03-16,HI,7,0,0,0,0,0,0,2020-03-16T20:00:00Z,0,7,7,7,15,0,0,0,5,5
2020-03-17,HI,10,0,0,0,0,0,0,2020-03-17T20:00:00Z,0,10,10,10,15,0,0,0,3,3
2020-03-18,HI,14,93,0,0,0,0,0,2020-03-18T20:00:00Z,0,107,107,107,15,0,0,93,4,97
2020-03-19,HI,16,93,0,0,0,0,0,2020-03-19T20:00:00Z,0,109,109,109,15,0,0,0,2,2
2020-03-20,HI,26,124,0,0,0,0,0,2020-03-20T20:00:00Z,0,150,150,150,15,0,0,31,10,41
2020-03-21,HI,37,124,0,0,0,0,0,2020-03-21T20:00:00Z,0,161,161,161,15,0,0,0,11,11
2020-03-22,HI,48,263,0,0,0,0,0,2020-03-22T20:00:00Z,0,311,311,311,15,0,0,139,11,150
2020-03-23,HI,56,2955,0,0,0,0,0,2020-03-23T20:00:00Z,0,3011,3011,3011,15,0,0,2692,8,2700
2020-03-24,HI,77,3589,0,0,0,0,0,2020-03-24T20:00:00Z,1,3666,3666,3666,15,1,4,634,21,655
2020-03-25,HI,90,4357,0,2,0,0,0,2020-03-25T20:00:00Z,1,4447,4447,4447,15,0,2,768,13,781
2020-03-26,HI,95,4357,0,0,0,0,0,2020-03-26T20:00:00Z,1,4452,4452,4452,15,0,-1,0,5,5
2020-03-27,HI,106,4357,0,0,0,0,0,2020-03-27T20:00:00Z,0,4463,4463,4463,15,0,2,0,11,11
2020-03-28,HI,120,4357,0,0,0,0,0,2020-03-28T20:00:00Z,0,4477,4477,4477,15,0,1,0,14,14
2020-03-29,HI,151,6849,0,0,0,0,0,2020-03-29T20:00:00Z,0,7000,7000,7000,15,0,4,2492,31,2523
2020-03-30,HI,175,7825,0,0,0,0,0,2020-03-30T20:00:00Z,0,8000,8000,8000,15,0,0,976,24,1000
2020-03-31,HI,204,8471,0,0,0,0,49,2020-03-31T20:00:00Z,0,8675,8675,8675,15,0,0,646,29,675
2020-04-01,HI,208,8721,0,0,0,0,58,2020-04-01T20:00:00Z,1,8929,8929,8929,15,1,1,250,4,254
2020-04-02,HI,258,10206,0,0,0,0,69,2020-04-02T20:00:00Z,1,10464,10464,10464,15,0,2,1485,50,1535
2020-04-03,HI,285,10206,0,0,0,0,72,2020-04-03T20:00:00Z,2,10491,10491,10491,15,1,0,0,27,27
2020-04-04,HI,319,11959,0,0,0,0,78,2020-04-04T20:00:00Z,3,12278,12278,12278,15,1,3,1753,34,1787
2020-04-05,HI,351,12604,0,0,0,0,82,2020-04-05T20:00:00Z,4,12955,12955,12955,15,1,1,645,32,677
2020-04-06,HI,371,13155,0,0,0,0,85,2020-04-06T20:00:00Z,4,13526,13526,13526,15,0,2,551,20,571
2020-03-06,IA,0,15,2,0,0,0,0,2020-03-06T21:00:00Z,0,17,15,15,19,0,0,0,0,0
2020-03-07,IA,0,15,2,0,0,0,0,2020-03-07T21:00:00Z,0,17,15,15,19,0,0,0,0,0
2020-03-08,IA,0,15,2,0,0,0,0,2020-03-08T20:00:00Z,0,17,15,15,19,0,0,0,0,0
2020-03-09,IA,3,26,8,0,0,0,0,2020-03-09T20:00:00Z,0,37,29,29,19,0,0,11,3,14
2020-03-10,IA,8,32,11,0,0,0,0,2020-03-10T20:00:00Z,0,51,40,40,19,0,0,6,5,11
2020-03-11,IA,13,46,27,0,0,0,0,2020-03-11T20:00:00Z,0,86,59,59,19,0,0,14,5,19
2020-03-12,IA,14,67,24,0,0,0,0,2020-03-12T20:00:00Z,0,105,81,81,19,0,0,21,1,22
2020-03-13,IA,16,83,29,0,0,0,0,2020-03-13T20:00:00Z,0,128,99,99,19,0,0,16,2,18
2020-03-14,IA,17,83,0,0,0,0,0,2020-03-14T20:00:00Z,0,100,100,100,19,0,0,0,1,1
2020-03-15,IA,18,83,0,0,0,0,0,2020-03-15T20:00:00Z,0,101,101,101,19,0,0,0,1,1
2020-03-16,IA,22,83,0,0,0,0,0,2020-03-16T20:00:00Z,0,105,105,105,19,0,0,0,4,4
2020-03-17,IA,23,83,0,0,0,0,0,2020-03-17T20:00:00Z,0,106,106,106,19,0,0,0,1,1
2020-03-18,IA,29,83,0,0,0,0,0,2020-03-18T20:00:00Z,0,112,112,112,19,0,0,0,6,6
2020-03-19,IA,38,83,0,0,0,0,0,2020-03-19T20:00:00Z,0,121,121,121,19,0,0,0,9,9
2020-03-20,IA,45,642,0,0,0,0,0,2020-03-20T20:00:00Z,0,687,687,687,19,0,0,559,7,566
2020-03-21,IA,68,1049,0,0,0,0,0,2020-03-21T20:00:00Z,0,1117,1117,1117,19,0,0,407,23,430
2020-03-22,IA,90,1215,0,0,0,0,0,2020-03-22T20:00:00Z,0,1305,1305,1305,19,0,0,166,22,188
2020-03-23,IA,105,2043,0,0,0,0,0,2020-03-23T20:00:00Z,0,2148,2148,2148,19,0,0,828,15,843
2020-03-24,IA,124,2315,0,0,0,0,0,2020-03-24T20:00:00Z,0,2439,2439,2439,19,0,27,272,19,291
2020-03-25,IA,145,2578,0,23,0,0,0,2020-03-25T20:00:00Z,1,2723,2723,2723,19,1,9,263,21,284
2020-03-26,IA,179,2578,0,31,0,0,15,2020-03-26T20:00:00Z,1,2757,2757,2757,19,0,10,0,34,34
2020-03-27,IA,235,3740,0,32,0,0,18,2020-03-27T20:00:00Z,3,3975,3975,3975,19,2,4,1162,56,1218
2020-03-28,IA,298,4375,0,46,0,0,18,2020-03-28T20:00:00Z,3,4673,4673,4673,19,0,11,635,63,698
2020-03-29,IA,336,5013,0,51,0,0,17,2020-03-29T20:00:00Z,4,5349,5349,5349,19,1,7,638,38,676
2020-03-30,IA,424,6162,0,51,0,0,23,2020-03-30T20:00:00Z,6,6586,6586,6586,19,2,6,1149,88,1237
2020-03-31,IA,497,6888,0,61,0,0,33,2020-03-31T20:00:00Z,7,7385,7385,7385,19,1,20,726,73,799
2020-04-01,IA,549,7304,0,63,0,0,118,2020-04-01T20:00:00Z,9,7853,7853,7853,19,2,5,416,52,468
2020-04-02,IA,614,8054,0,74,0,0,118,2020-04-02T20:00:00Z,11,8668,8668,8668,19,2,21,750,65,815
2020-04-03,IA,699,8754,0,80,0,0,188,2020-04-03T20:00:00Z,11,9453,9453,9453,19,0,18,700,85,785
2020-04-04,IA,786,9454,0,85,0,0,188,2020-04-04T20:00:00Z,14,10240,10240,10240,19,3,15,700,87,787
2020-04-05,IA,868,9973,0,91,0,0,188,2020-04-05T20:00:00Z,22,10841,10841,10841,19,8,12,519,82,601
2020-04-06,IA,946,10653,0,99,0,0,284,2020-04-06T20:00:00Z,25,11599,11599,11599,19,3,14,680,78,758
2020-03-07,ID,0,27,0,0,0,0,0,2020-03-07T21:00:00Z,0,27,27,27,16,0,0,0,0,0
2020-03-08,ID,0,27,0,0,0,0,0,2020-03-08T20:00:00Z,0,27,27,27,16,0,0,0,0,0
2020-03-09,ID,0,41,0,0,0,0,0,2020-03-09T20:00:00Z,0,41,41,41,16,0,0,14,0,14
2020-03-10,ID,0,41,0,0,0,0,0,2020-03-10T20:00:00Z,0,41,41,41,16,0,0,0,0,0
2020-03-11,ID,0,67,0,0,0,0,0,2020-03-11T20:00:00Z,0,67,67,67,16,0,0,26,0,26
2020-03-12,ID,0,93,0,0,0,0,0,2020-03-12T20:00:00Z,0,93,93,93,16,0,0,26,0,26
2020-03-13,ID,0,131,0,0,0,0,0,2020-03-13T20:00:00Z,0,131,131,131,16,0,0,38,0,38
2020-03-14,ID,2,174,0,0,0,0,0,2020-03-14T20:00:00Z,0,176,176,176,16,0,0,43,2,45
2020-03-15,ID,5,174,0,0,0,0,0,2020-03-15T20:00:00Z,0,179,179,179,16,0,0,0,3,3
2020-03-16,ID,5,265,0,0,0,0,0,2020-03-16T20:00:00Z,0,270,270,270,16,0,0,91,0,91
2020-03-17,ID,7,346,0,0,0,0,0,2020-03-17T20:00:00Z,0,353,353,353,16,0,0,81,2,83
2020-03-18,ID,9,459,0,0,0,0,0,2020-03-18T20:00:00Z,0,468,468,468,16,0,0,113,2,115
2020-03-19,ID,11,459,0,0,0,0,0,2020-03-19T20:00:00Z,0,470,470,470,16,0,0,0,2,2
2020-03-20,ID,23,590,0,0,0,0,0,2020-03-20T20:00:00Z,0,613,613,613,16,0,0,131,12,143
2020-03-21,ID,31,880,0,0,0,0,0,2020-03-21T20:00:00Z,0,911,911,911,16,0,0,290,8,298
2020-03-22,ID,42,1175,0,0,0,0,0,2020-03-22T20:00:00Z,0,1217,1217,1217,16,0,0,295,11,306
2020-03-23,ID,47,1309,0,0,0,0,0,2020-03-23T20:00:00Z,0,1356,1356,1356,16,0,0,134,5,139
2020-03-24,ID,50,1887,0,0,0,0,0,2020-03-24T20:00:00Z,0,1937,1937,1937,16,0,0,578,3,581
2020-03-25,ID,73,1887,0,0,0,0,0,2020-03-25T20:00:00Z,0,1960,1960,1960,16,0,0,0,23,23
2020-03-26,ID,123,2065,0,0,0,0,0,2020-03-26T20:00:00Z,0,2188,2188,2188,16,0,0,178,50,228
2020-03-27,ID,189,2668,0,0,0,0,0,2020-03-27T20:00:00Z,3,2857,2857,2857,16,3,0,603,66,669
2020-03-28,ID,230,3342,0,0,0,0,0,2020-03-28T20:00:00Z,4,3572,3572,3572,16,1,25,674,41,715
2020-03-29,ID,261,4021,0,0,0,0,0,2020-03-29T20:00:00Z,5,4282,4282,4282,16,1,11,679,31,710
2020-03-30,ID,310,4396,0,0,0,0,0,2020-03-30T20:00:00Z,6,4706,4706,4706,16,1,3,375,49,424
2020-03-31,ID,415,5297,0,0,0,0,0,2020-03-31T20:00:00Z,7,5712,5712,5712,16,1,6,901,105,1006
2020-04-01,ID,525,6076,0,0,0,0,0,2020-04-01T20:00:00Z,9,6601,6601,6601,16,2,1,779,110,889
2020-04-02,ID,669,6613,0,0,0,0,0,2020-04-02T20:00:00Z,9,7282,7282,7282,16,0,3,537,144,681
2020-04-03,ID,891,7054,0,0,0,0,0,2020-04-03T20:00:00Z,9,7945,7945,7945,16,0,7,441,222,663
2020-04-04,ID,1013,7857,0,0,0,0,0,2020-04-04T20:00:00Z,10,8870,8870,8870,16,1,6,803,122,925
2020-04-05,ID,1077,9184,0,0,0,0,0,2020-04-05T20:00:00Z,10,10261,10261,10261,16,0,4,1327,64,1391
2020-04-06,ID,1101,9894,0,0,0,0,0,2020-04-06T20:00:00Z,10,10995,10995,10995,16,0,11,710,24,734
2020-03-04,IL,4,124,27,0,0,0,0,2020-03-04T21:00:00Z,0,155,128,128,17,0,0,0,0,0
2020-03-05,IL,5,165,27,0,0,0,0,2020-03-05T21:00:00Z,0,197,170,170,17,0,0,41,1,42
2020-03-06,IL,5,180,35,0,0,0,0,2020-03-06T21:00:00Z,0,220,185,185,17,0,0,15,0,15
2020-03-07,IL,6,191,44,0,0,0,0,2020-03-07T21:00:00Z,0,241,197,197,17,0,0,11,1,12
2020-03-08,IL,6,191,44,0,0,0,0,2020-03-08T20:00:00Z,0,241,197,197,17,0,0,0,0,0
2020-03-09,IL,7,191,44,0,0,0,0,2020-03-09T20:00:00Z,0,242,198,198,17,0,0,0,1,1
2020-03-10,IL,19,244,63,0,0,0,0,2020-03-10T20:00:00Z,0,326,263,263,17,0,0,53,12,65
2020-03-11,IL,19,244,63,0,0,0,0,2020-03-11T20:00:00Z,0,326,263,263,17,0,0,0,0,0
2020-03-12,IL,25,266,76,0,0,0,0,2020-03-12T20:00:00Z,0,367,291,291,17,0,0,22,6,28
2020-03-13,IL,32,294,92,0,0,0,0,2020-03-13T20:00:00Z,0,418,326,326,17,0,0,28,7,35
2020-03-14,IL,46,316,82,0,0,0,0,2020-03-14T20:00:00Z,0,444,362,362,17,0,0,22,14,36
2020-03-15,IL,64,449,195,0,0,0,0,2020-03-15T20:00:00Z,0,708,513,513,17,0,0,133,18,151
2020-03-16,IL,93,932,0,0,0,0,0,2020-03-16T20:00:00Z,0,1025,1025,1025,17,0,0,483,29,512
2020-03-17,IL,159,1340,0,0,0,0,0,2020-03-17T20:00:00Z,1,1499,1499,1499,17,1,0,408,66,474
2020-03-18,IL,288,1763,0,0,0,0,0,2020-03-18T20:00:00Z,1,2051,2051,2051,17,0,0,423,129,552
2020-03-19,IL,422,2725,0,0,0,0,0,2020-03-19T20:00:00Z,4,3147,3147,3147,17,3,0,962,134,1096
2020-03-20,IL,585,3696,0,0,0,0,0,2020-03-20T20:00:00Z,5,4281,4281,4281,17,1,0,971,163,1134
2020-03-21,IL,753,5488,0,0,0,0,0,2020-03-21T20:00:00Z,6,6241,6241,6241,17,1,0,1792,168,1960
2020-03-22,IL,1049,7271,0,0,0,0,0,2020-03-22T20:00:00Z,9,8320,8320,8320,17,3,0,1783,296,2079
2020-03-23,IL,1273,8583,0,0,0,0,0,2020-03-23T20:00:00Z,12,9856,9856,9856,17,3,0,1312,224,1536
2020-03-24,IL,1535,9934,0,0,0,0,0,2020-03-24T20:00:00Z,16,11469,11469,11469,17,4,0,1351,262,1613
2020-03-25,IL,1865,12344,0,0,0,0,0,2020-03-25T20:00:00Z,19,14209,14209,14209,17,3,0,2410,330,2740
2020-03-26,IL,2538,14093,0,0,0,0,0,2020-03-26T20:00:00Z,26,16631,16631,16631,17,7,0,1749,673,2422
2020-03-27,IL,3026,18516,0,0,0,0,0,2020-03-27T20:00:00Z,34,21542,21542,21542,17,8,0,4423,488,4911
2020-03-28,IL,3491,22000,0,0,0,0,0,2020-03-28T20:00:00Z,47,25491,25491,25491,17,13,0,3484,465,3949
2020-03-29,IL,4596,23166,0,0,0,0,0,2020-03-29T20:00:00Z,65,27762,27762,27762,17,18,0,1166,1105,2271
2020-03-30,IL,5057,25389,0,0,0,0,0,2020-03-30T20:00:00Z,73,30446,30446,30446,17,8,0,2223,461,2684
2020-03-31,IL,5994,29231,0,0,0,0,0,2020-03-31T20:00:00Z,99,35225,35225,35225,17,26,0,3842,937,4779
2020-04-01,IL,6980,33404,0,0,0,0,0,2020-04-01T20:00:00Z,141,40384,40384,40384,17,42,0,4173,986,5159
2020-04-02,IL,7695,35961,0,0,0,0,0,2020-04-02T20:00:00Z,157,43656,43656,43656,17,16,0,2557,715,3272
2020-04-03,IL,8904,39144,0,0,0,0,0,2020-04-03T20:00:00Z,210,48048,48048,48048,17,53,0,3183,1209,4392
2020-04-04,IL,10357,43224,0,0,0,0,0,2020-04-04T20:00:00Z,243,53581,53581,53581,17,33,0,4080,1453,5533
2020-04-05,IL,11256,47727,0,0,0,0,0,2020-04-05T20:00:00Z,274,58983,58983,58983,17,31,0,4503,899,5402
2020-04-06,IL,12262,50680,0,0,0,0,0,2020-04-06T20:00:00Z,307,62942,62942,62942,17,33,0,2953,1006,3959
2020-03-06,IN,1,0,0,0,0,0,0,2020-03-06T21:00:00Z,0,1,1,1,18,0,0,0,0,0
2020-03-07,IN,1,0,0,0,0,0,0,2020-03-07T21:00:00Z,0,1,1,1,18,0,0,0,0,0
2020-03-08,IN,2,0,0,0,0,0,0,2020-03-08T20:00:00Z,0,2,2,2,18,0,0,0,1,1
2020-03-09,IN,2,0,0,0,0,0,0,2020-03-09T20:00:00Z,0,2,2,2,18,0,0,0,0,0
2020-03-10,IN,6,30,0,0,0,0,0,2020-03-10T20:00:00Z,0,36,36,36,18,0,0,30,4,34
2020-03-11,IN,10,33,0,0,0,0,0,2020-03-11T20:00:00Z,0,43,43,43,18,0,0,3,4,7
2020-03-12,IN,12,52,0,0,0,0,0,2020-03-12T20:00:00Z,0,64,64,64,18,0,0,19,2,21
2020-03-13,IN,12,61,0,0,0,0,0,2020-03-13T20:00:00Z,0,73,73,73,18,0,0,9,0,9
2020-03-14,IN,15,74,0,0,0,0,0,2020-03-14T20:00:00Z,0,89,89,89,18,0,0,13,3,16
2020-03-15,IN,19,102,0,0,0,0,0,2020-03-15T20:00:00Z,0,121,121,121,18,0,0,28,4,32
2020-03-16,IN,24,115,0,0,0,0,0,2020-03-16T20:00:00Z,1,139,139,139,18,1,0,13,5,18
2020-03-17,IN,30,129,0,0,0,0,0,2020-03-17T20:00:00Z,2,159,159,159,18,1,0,14,6,20
2020-03-18,IN,39,154,0,0,0,0,0,2020-03-18T20:00:00Z,2,193,193,193,18,0,0,25,9,34
2020-03-19,IN,56,324,0,0,0,0,0,2020-03-19T20:00:00Z,2,380,380,380,18,0,0,170,17,187
2020-03-20,IN,79,475,0,0,0,0,0,2020-03-20T20:00:00Z,2,554,554,554,18,0,0,151,23,174
2020-03-21,IN,126,707,0,0,0,0,0,2020-03-21T20:00:00Z,4,833,833,833,18,2,1,232,47,279
2020-03-22,IN,201,1293,0,0,0,0,0,2020-03-22T20:00:00Z,6,1494,1494,1494,18,2,0,586,75,661
2020-03-23,IN,259,1701,0,0,0,0,0,2020-03-23T20:00:00Z,7,1960,1960,1960,18,1,0,408,58,466
2020-03-24,IN,365,2566,0,0,0,0,0,2020-03-24T20:00:00Z,12,2931,2931,2931,18,5,0,865,106,971
2020-03-25,IN,477,2879,0,0,0,0,0,2020-03-25T20:00:00Z,14,3356,3356,3356,18,2,0,313,112,425
2020-03-26,IN,645,4006,0,0,0,0,0,2020-03-26T20:00:00Z,17,4651,4651,4651,18,3,0,1127,168,1295
2020-03-27,IN,981,5955,0,0,0,0,0,2020-03-27T20:00:00Z,24,6936,6936,6936,18,7,0,1949,336,2285
2020-03-28,IN,1232,7175,0,0,0,0,0,2020-03-28T20:00:00Z,31,8407,8407,8407,18,7,0,1220,251,1471
2020-03-29,IN,1514,8316,0,0,0,0,0,2020-03-29T20:00:00Z,32,9830,9830,9830,18,1,0,1141,282,1423
2020-03-30,IN,1786,9872,0,0,0,0,0,2020-03-30T20:00:00Z,35,11658,11658,11658,18,3,0,1556,272,1828
2020-03-31,IN,2159,11214,0,0,0,0,0,2020-03-31T20:00:00Z,49,13373,13373,13373,18,14,0,1342,373,1715
2020-04-01,IN,2565,11810,0,0,0,0,0,2020-04-01T20:00:00Z,65,14375,14375,14375,18,16,0,596,406,1002
2020-04-02,IN,3039,13246,0,0,0,0,0,2020-04-02T20:00:00Z,78,16285,16285,16285,18,13,0,1436,474,1910
2020-04-03,IN,3437,14398,0,0,0,0,0,2020-04-03T20:00:00Z,102,17835,17835,17835,18,24,0,1152,398,1550
2020-04-04,IN,3953,15847,0,0,0,0,0,2020-04-04T20:00:00Z,116,19800,19800,19800,18,14,0,1449,516,1965
2020-04-05,IN,4411,18241,0,0,0,0,0,2020-04-05T20:00:00Z,127,22652,22652,22652,18,11,0,2394,458,2852
2020-04-06,IN,4944,21247,0,0,924,507,0,2020-04-06T20:00:00Z,139,26191,26191,26191,18,12,0,3006,533,3539
2020-03-06,KS,0,4,0,0,0,0,0,2020-03-06T21:00:00Z,0,4,4,4,20,0,0,0,0,0
2020-03-07,KS,0,11,2,0,0,0,0,2020-03-07T21:00:00Z,0,13,11,11,20,0,0,7,0,7
2020-03-08,KS,1,11,0,0,0,0,0,2020-03-08T20:00:00Z,0,12,12,12,20,0,0,0,1,1
2020-03-09,KS,1,11,0,0,0,0,0,2020-03-09T20:00:00Z,0,12,12,12,20,0,0,0,0,0
2020-03-10,KS,1,17,21,0,0,0,0,2020-03-10T20:00:00Z,0,39,18,18,20,0,0,6,0,6
2020-03-11,KS,1,41,0,0,0,0,0,2020-03-11T20:00:00Z,0,42,42,42,20,0,0,24,0,24
2020-03-12,KS,4,41,0,0,0,0,0,2020-03-12T20:00:00Z,0,45,45,45,20,0,0,0,3,3
2020-03-13,KS,6,93,0,0,0,0,0,2020-03-13T20:00:00Z,0,99,99,99,20,0,0,52,2,54
2020-03-14,KS,6,93,0,0,0,0,0,2020-03-14T20:00:00Z,1,99,99,99,20,1,0,0,0,0
2020-03-15,KS,8,135,0,0,0,0,0,2020-03-15T20:00:00Z,1,143,143,143,20,0,0,42,2,44
2020-03-16,KS,11,166,0,0,0,0,0,2020-03-16T20:00:00Z,1,177,177,177,20,0,0,31,3,34
2020-03-17,KS,15,382,0,0,0,0,0,2020-03-17T20:00:00Z,1,397,397,397,20,0,0,216,4,220
2020-03-18,KS,16,417,0,0,0,0,0,2020-03-18T20:00:00Z,1,433,433,433,20,0,0,35,1,36
2020-03-19,KS,34,417,0,0,0,0,0,2020-03-19T20:00:00Z,1,451,451,451,20,0,0,0,18,18
2020-03-20,KS,44,417,0,0,0,0,0,2020-03-20T20:00:00Z,1,461,461,461,20,0,0,0,10,10
2020-03-21,KS,55,417,0,0,0,0,0,2020-03-21T20:00:00Z,2,472,472,472,20,1,0,0,11,11
2020-03-22,KS,64,417,0,0,0,0,0,2020-03-22T20:00:00Z,2,481,481,481,20,0,0,0,9,9
2020-03-23,KS,82,417,0,0,0,0,0,2020-03-23T20:00:00Z,2,499,499,499,20,0,0,0,18,18
2020-03-24,KS,98,2086,0,0,0,0,0,2020-03-24T20:00:00Z,2,2184,2184,2184,20,0,0,1669,16,1685
2020-03-25,KS,126,2360,0,0,0,0,0,2020-03-25T20:00:00Z,3,2486,2486,2486,20,1,0,274,28,302
2020-03-26,KS,168,2869,0,0,0,0,0,2020-03-26T20:00:00Z,3,3037,3037,3037,20,0,0,509,42,551
2020-03-27,KS,202,3229,0,0,0,0,0,2020-03-27T20:00:00Z,4,3431,3431,3431,20,1,27,360,34,394
2020-03-28,KS,261,3671,0,0,0,0,0,2020-03-28T20:00:00Z,5,3932,3932,3932,20,1,0,442,59,501
2020-03-29,KS,319,4194,0,0,0,0,0,2020-03-29T20:00:00Z,6,4513,4513,4513,20,1,28,523,58,581
2020-03-30,KS,368,4554,0,0,0,0,0,2020-03-30T20:00:00Z,8,4922,4922,4922,20,2,11,360,49,409
2020-03-31,KS,428,4996,0,0,0,0,0,2020-03-31T20:00:00Z,9,5424,5424,5424,20,1,13,442,60,502
2020-04-01,KS,482,5411,0,0,0,0,0,2020-04-01T20:00:00Z,10,5893,5893,5893,20,1,35,415,54,469
2020-04-02,KS,552,6059,0,0,0,0,0,2020-04-02T20:00:00Z,13,6611,6611,6611,20,3,24,648,70,718
2020-04-03,KS,620,6454,0,0,0,0,0,2020-04-03T20:00:00Z,17,7074,7074,7074,20,4,13,395,68,463
2020-04-04,KS,698,6880,0,0,0,0,0,2020-04-04T20:00:00Z,21,7578,7578,7578,20,4,21,426,78,504
2020-04-05,KS,747,7476,0,0,0,0,0,2020-04-05T20:00:00Z,22,8223,8223,8223,20,1,11,596,49,645
2020-04-06,KS,845,8239,0,0,0,0,0,2020-04-06T20:00:00Z,25,9084,9084,9084,20,3,15,763,98,861
2020-03-06,KY,0,7,3,0,0,0,0,2020-03-06T21:00:00Z,0,10,7,7,21,0,0,0,0,0
2020-03-07,KY,1,9,0,0,0,0,0,2020-03-07T21:00:00Z,0,10,10,10,21,0,0,2,1,3
2020-03-08,KY,1,13,0,0,0,0,0,2020-03-08T20:00:00Z,0,14,14,14,21,0,0,4,0,4
2020-03-09,KY,4,17,0,0,0,0,0,2020-03-09T20:00:00Z,0,21,21,21,21,0,0,4,3,7
2020-03-10,KY,6,28,0,0,0,0,0,2020-03-10T20:00:00Z,0,34,34,34,21,0,0,11,2,13
2020-03-11,KY,8,46,0,0,0,0,0,2020-03-11T20:00:00Z,0,54,54,54,21,0,0,18,2,20
2020-03-12,KY,8,56,0,0,0,0,0,2020-03-12T20:00:00Z,0,64,64,64,21,0,0,10,0,10
2020-03-13,KY,11,107,0,0,0,0,0,2020-03-13T20:00:00Z,0,118,118,118,21,0,0,51,3,54
2020-03-14,KY,14,139,0,0,0,0,0,2020-03-14T20:00:00Z,0,153,153,153,21,0,0,32,3,35
2020-03-15,KY,16,139,0,0,0,0,0,2020-03-15T20:00:00Z,0,155,155,155,21,0,0,0,2,2
2020-03-16,KY,21,234,0,0,0,0,0,2020-03-16T20:00:00Z,1,255,255,255,21,1,0,95,5,100
2020-03-17,KY,22,295,0,0,0,0,0,2020-03-17T20:00:00Z,1,317,317,317,21,0,0,61,1,62
2020-03-18,KY,26,354,0,0,0,0,0,2020-03-18T20:00:00Z,1,380,380,380,21,0,0,59,4,63
2020-03-19,KY,35,454,0,0,0,0,0,2020-03-19T20:00:00Z,1,489,489,489,21,0,0,100,9,109
2020-03-20,KY,47,592,0,0,0,0,0,2020-03-20T20:00:00Z,1,639,639,639,21,0,0,138,12,150
2020-03-21,KY,54,714,0,0,0,0,0,2020-03-21T20:00:00Z,2,768,768,768,21,1,0,122,7,129
2020-03-22,KY,99,1472,0,0,0,0,0,2020-03-22T20:00:00Z,3,1571,1571,1571,21,1,0,758,45,803
2020-03-23,KY,104,1762,0,0,0,0,0,2020-03-23T20:00:00Z,3,1866,1866,1866,21,0,0,290,5,295
2020-03-24,KY,124,1762,0,0,0,0,0,2020-03-24T20:00:00Z,4,1886,1886,1886,21,1,0,0,20,20
2020-03-25,KY,157,2865,0,0,0,0,0,2020-03-25T20:00:00Z,4,3022,3022,3022,21,0,0,1103,33,1136
2020-03-26,KY,198,3102,0,0,0,0,0,2020-03-26T20:00:00Z,4,3300,3300,3300,21,0,0,237,41,278
2020-03-27,KY,248,3768,0,0,0,0,0,2020-03-27T20:00:00Z,6,4016,4016,4016,21,2,0,666,50,716
2020-03-28,KY,302,4821,0,0,0,0,0,2020-03-28T20:00:00Z,8,5123,5123,5123,21,2,0,1053,54,1107
2020-03-29,KY,394,5147,0,0,0,0,0,2020-03-29T20:00:00Z,9,5541,5541,5541,21,1,0,326,92,418
2020-03-30,KY,439,5579,0,0,0,0,0,2020-03-30T20:00:00Z,9,6018,6018,6018,21,0,0,432,45,477
2020-03-31,KY,480,6330,0,0,0,0,0,2020-03-31T20:00:00Z,11,6810,6810,6810,21,2,0,751,41,792
2020-04-01,KY,591,6965,0,0,0,0,0,2020-04-01T20:00:00Z,17,7556,7556,7556,21,6,0,635,111,746
2020-04-02,KY,680,7220,0,0,0,0,0,2020-04-02T20:00:00Z,20,7900,7900,7900,21,3,0,255,89,344
2020-04-03,KY,770,12034,0,0,0,0,0,2020-04-03T20:00:00Z,31,12804,12804,12804,21,11,0,4814,90,4904
2020-04-04,KY,831,14741,0,0,0,0,0,2020-04-04T20:00:00Z,37,15572,15572,15572,21,6,0,2707,61,2768
2020-04-05,KY,917,15746,0,0,0,0,0,2020-04-05T20:00:00Z,40,16663,16663,16663,21,3,0,1005,86,1091
2020-04-06,KY,955,17812,0,0,0,0,0,2020-04-06T20:00:00Z,45,18767,18767,18767,21,5,0,2066,38,2104
2020-03-07,LA,0,0,0,0,0,0,0,2020-03-07T21:00:00Z,0,0,0,0,22,0,0,0,0,0
2020-03-08,LA,0,5,0,0,0,0,0,2020-03-08T20:00:00Z,0,5,5,5,22,0,0,5,0,5
2020-03-09,LA,1,5,0,0,0,0,0,2020-03-09T20:00:00Z,0,6,6,6,22,0,0,0,1,1
2020-03-10,LA,1,11,0,0,0,0,0,2020-03-10T20:00:00Z,0,12,12,12,22,0,0,6,0,6
2020-03-11,LA,6,37,0,0,0,0,0,2020-03-11T20:00:00Z,0,43,43,43,22,0,0,26,5,31
2020-03-12,LA,14,37,0,0,0,0,0,2020-03-12T20:00:00Z,0,51,51,51,22,0,0,0,8,8
2020-03-13,LA,36,37,0,0,0,0,0,2020-03-13T20:00:00Z,0,73,73,73,22,0,0,0,22,22
2020-03-14,LA,69,109,0,0,0,0,0,2020-03-14T20:00:00Z,0,178,178,178,22,0,0,72,33,105
2020-03-15,LA,91,156,0,0,0,0,0,2020-03-15T20:00:00Z,2,247,247,247,22,2,0,47,22,69
2020-03-16,LA,114,188,0,0,0,0,0,2020-03-16T20:00:00Z,2,302,302,302,22,0,0,32,23,55
2020-03-17,LA,171,286,0,0,0,0,0,2020-03-17T20:00:00Z,4,457,457,457,22,2,0,98,57,155
2020-03-18,LA,240,335,0,0,0,0,0,2020-03-18T20:00:00Z,6,575,575,575,22,2,0,49,69,118
2020-03-19,LA,347,458,0,0,0,0,0,2020-03-19T20:00:00Z,8,805,805,805,22,2,0,123,107,230
2020-03-20,LA,479,568,0,0,0,0,0,2020-03-20T20:00:00Z,12,1047,1047,1047,22,4,0,110,132,242
2020-03-21,LA,585,2180,0,0,0,0,0,2020-03-21T20:00:00Z,16,2765,2765,2765,22,4,0,1612,106,1718
2020-03-22,LA,837,2661,0,0,0,0,0,2020-03-22T20:00:00Z,20,3498,3498,3498,22,4,0,481,252,733
2020-03-23,LA,1172,4776,0,0,0,0,0,2020-03-23T20:00:00Z,34,5948,5948,5948,22,14,0,2115,335,2450
2020-03-24,LA,1388,7215,0,0,0,0,0,2020-03-24T20:00:00Z,46,8603,8603,8603,22,12,271,2439,216,2655
2020-03-25,LA,1795,9656,0,0,0,0,0,2020-03-25T20:00:00Z,65,11451,11451,11451,22,19,220,2441,407,2848
2020-03-26,LA,2305,15724,0,0,0,0,0,2020-03-26T20:00:00Z,83,18029,18029,18029,22,18,185,6068,510,6578
2020-03-27,LA,2746,18613,0,0,0,0,0,2020-03-27T20:00:00Z,119,21359,21359,21359,22,36,97,2889,441,3330
2020-03-28,LA,3315,21846,0,0,0,0,0,2020-03-28T20:00:00Z,137,25161,25161,25161,22,18,154,3233,569,3802
2020-03-29,LA,3540,24331,0,0,0,0,0,2020-03-29T20:00:00Z,151,27871,27871,27871,22,14,200,2485,225,2710
2020-03-30,LA,4025,30008,0,0,0,0,0,2020-03-30T20:00:00Z,185,34033,34033,34033,22,34,58,5677,485,6162
2020-03-31,LA,5237,33730,0,0,0,0,0,2020-03-31T20:00:00Z,239,38967,38967,38967,22,54,170,3722,1212,4934
2020-04-01,LA,6424,39352,0,0,0,0,0,2020-04-01T20:00:00Z,273,45776,45776,45776,22,34,143,5622,1187,6809
2020-04-02,LA,9150,41936,0,0,0,0,0,2020-04-02T20:00:00Z,310,51086,51086,51086,22,37,141,2584,2726,5310
2020-04-03,LA,10297,43348,0,0,0,0,0,2020-04-03T20:00:00Z,370,53645,53645,53645,22,60,68,1412,1147,2559
2020-04-04,LA,12496,46002,0,1726,0,571,0,2020-04-04T20:00:00Z,409,58498,58498,58498,22,39,0,2654,2199,4853
2020-04-05,LA,13010,47315,0,1803,0,561,0,2020-04-05T20:00:00Z,477,60325,60325,60325,22,68,0,1313,514,1827
2020-04-06,LA,14867,54299,0,1809,0,563,0,2020-04-06T20:00:00Z,512,69166,69166,69166,22,35,0,6984,1857,8841
2020-03-04,MA,2,0,0,0,0,0,0,2020-03-04T21:00:00Z,0,2,2,2,25,0,0,0,0,0
2020-03-05,MA,2,0,0,0,0,0,0,2020-03-05T21:00:00Z,0,2,2,2,25,0,0,0,0,0
2020-03-06,MA,8,0,0,0,0,0,0,2020-03-06T21:00:00Z,0,8,8,8,25,0,0,0,6,6
2020-03-07,MA,13,0,0,0,0,0,0,2020-03-07T21:00:00Z,0,13,13,13,25,0,0,0,5,5
2020-03-08,MA,13,0,0,0,0,0,0,2020-03-08T20:00:00Z,0,13,13,13,25,0,0,0,0,0
2020-03-09,MA,41,0,0,0,0,0,0,2020-03-09T20:00:00Z,0,41,41,41,25,0,0,0,28,28
2020-03-10,MA,92,0,0,0,0,0,0,2020-03-10T20:00:00Z,0,92,92,92,25,0,0,0,51,51
2020-03-11,MA,92,0,0,0,0,0,0,2020-03-11T20:00:00Z,0,92,92,92,25,0,0,0,0,0
2020-03-12,MA,95,0,0,0,0,0,0,2020-03-12T20:00:00Z,0,95,95,95,25,0,0,0,3,3
2020-03-13,MA,123,92,0,0,0,0,0,2020-03-13T20:00:00Z,0,215,215,215,25,0,0,92,28,120
2020-03-14,MA,138,352,0,0,0,0,0,2020-03-14T20:00:00Z,0,490,490,490,25,0,0,260,15,275
2020-03-15,MA,138,352,0,0,0,0,0,2020-03-15T20:00:00Z,0,490,490,490,25,0,0,0,0,0
2020-03-16,MA,164,352,0,0,0,0,0,2020-03-16T20:00:00Z,0,516,516,516,25,0,0,0,26,26
2020-03-17,MA,218,1541,0,0,0,0,0,2020-03-17T20:00:00Z,0,1759,1759,1759,25,0,0,1189,54,1243
2020-03-18,MA,256,2015,0,0,0,0,0,2020-03-18T20:00:00Z,0,2271,2271,2271,25,0,0,474,38,512
2020-03-19,MA,328,2804,0,0,0,0,0,2020-03-19T20:00:00Z,0,3132,3132,3132,25,0,0,789,72,861
2020-03-20,MA,413,3678,0,0,0,0,0,2020-03-20T20:00:00Z,1,4091,4091,4091,25,1,0,874,85,959
2020-03-21,MA,525,4752,0,0,0,0,0,2020-03-21T20:00:00Z,1,5277,5277,5277,25,0,61,1074,112,1186
2020-03-22,MA,646,5459,0,0,0,0,0,2020-03-22T20:00:00Z,5,6105,6105,6105,25,4,10,707,121,828
2020-03-23,MA,777,8145,0,0,0,0,0,2020-03-23T20:00:00Z,9,8922,8922,8922,25,4,8,2686,131,2817
2020-03-24,MA,1159,12590,0,0,0,0,0,2020-03-24T20:00:00Z,11,13749,13749,13749,25,2,15,4445,382,4827
2020-03-25,MA,1838,17956,0,0,0,0,0,2020-03-25T20:00:00Z,15,19794,19794,19794,25,4,9,5366,679,6045
2020-03-26,MA,2417,21204,0,0,0,0,0,2020-03-26T20:00:00Z,25,23621,23621,23621,25,10,116,3248,579,3827
2020-03-27,MA,3240,26131,0,0,0,0,0,2020-03-27T20:00:00Z,35,29371,29371,29371,25,10,0,4927,823,5750
2020-03-28,MA,4257,30792,0,0,0,0,0,2020-03-28T20:00:00Z,44,35049,35049,35049,25,9,131,4661,1017,5678
2020-03-29,MA,4955,34111,0,0,0,0,0,2020-03-29T20:00:00Z,48,39066,39066,39066,25,4,49,3319,698,4017
2020-03-30,MA,5752,37041,0,0,0,0,0,2020-03-30T20:00:00Z,56,42793,42793,42793,25,8,54,2930,797,3727
2020-03-31,MA,6620,40315,0,0,0,0,0,2020-03-31T20:00:00Z,89,46935,46935,46935,25,33,109,3274,868,4142
2020-04-01,MA,7738,44000,0,0,0,0,0,2020-04-01T20:00:00Z,122,51738,51738,51738,25,33,120,3685,1118,4803
2020-04-02,MA,8966,47642,0,0,0,0,0,2020-04-02T20:00:00Z,154,56608,56608,56608,25,32,131,3642,1228,4870
2020-04-03,MA,10402,52560,0,0,0,0,0,2020-04-03T20:00:00Z,192,62962,62962,62962,25,38,153,4918,1436,6354
2020-04-04,MA,11736,57064,0,0,0,0,0,2020-04-04T20:00:00Z,216,68800,68800,68800,25,24,102,4504,1334,5838
2020-04-05,MA,12500,59437,0,0,0,0,0,2020-04-05T20:00:00Z,231,71937,71937,71937,25,15,77,2373,764,3137
2020-04-06,MA,13837,62592,0,0,0,0,0,2020-04-06T20:00:00Z,260,76429,76429,76429,25,29,96,3155,1337,4492
2020-03-05,MD,0,17,14,0,0,0,0,2020-03-05T21:00:00Z,0,31,17,17,24,0,0,0,0,0
2020-03-06,MD,3,26,12,0,0,0,0,2020-03-06T21:00:00Z,0,41,29,29,24,0,0,9,3,12
2020-03-07,MD,3,41,0,0,0,0,0,2020-03-07T21:00:00Z,0,44,44,44,24,0,0,15,0,15
2020-03-08,MD,3,52,0,0,0,0,0,2020-03-08T20:00:00Z,0,55,55,55,24,0,0,11,0,11
2020-03-09,MD,5,73,0,0,0,0,0,2020-03-09T20:00:00Z,0,78,78,78,24,0,0,21,2,23
2020-03-10,MD,6,89,0,0,0,0,0,2020-03-10T20:00:00Z,0,95,95,95,24,0,0,16,1,17
2020-03-11,MD,9,94,0,0,0,0,0,2020-03-11T20:00:00Z,0,103,103,103,24,0,0,5,3,8
2020-03-12,MD,12,94,0,0,0,0,0,2020-03-12T20:00:00Z,0,106,106,106,24,0,0,0,3,3
2020-03-13,MD,17,94,0,0,0,0,0,2020-03-13T20:00:00Z,0,111,111,111,24,0,0,0,5,5
2020-03-14,MD,26,94,0,0,0,0,0,2020-03-14T20:00:00Z,0,120,120,120,24,0,0,0,9,9
2020-03-15,MD,31,94,0,0,0,0,0,2020-03-15T20:00:00Z,0,125,125,125,24,0,0,0,5,5
2020-03-16,MD,37,94,0,0,0,0,0,2020-03-16T20:00:00Z,0,131,131,131,24,0,0,0,6,6
2020-03-17,MD,57,94,0,0,0,0,0,2020-03-17T20:00:00Z,0,151,151,151,24,0,0,0,20,20
2020-03-18,MD,85,94,0,0,0,0,0,2020-03-18T20:00:00Z,0,179,179,179,24,0,0,0,28,28
2020-03-19,MD,107,94,0,0,0,0,0,2020-03-19T20:00:00Z,1,201,201,201,24,1,0,0,22,22
2020-03-20,MD,149,94,0,0,0,0,0,2020-03-20T20:00:00Z,1,243,243,243,24,0,0,0,42,42
2020-03-21,MD,190,94,0,0,0,0,0,2020-03-21T20:00:00Z,2,284,284,284,24,1,0,0,41,41
2020-03-22,MD,244,94,0,0,0,0,0,2020-03-22T20:00:00Z,3,338,338,338,24,1,0,0,54,54
2020-03-23,MD,288,94,0,0,0,0,0,2020-03-23T20:00:00Z,3,382,382,382,24,0,0,0,44,44
2020-03-24,MD,349,94,0,0,0,0,0,2020-03-24T20:00:00Z,3,443,443,443,24,0,0,0,61,61
2020-03-25,MD,423,94,0,0,0,0,0,2020-03-25T20:00:00Z,4,517,517,517,24,1,0,0,74,74
2020-03-26,MD,580,94,0,0,0,0,0,2020-03-26T20:00:00Z,4,674,674,674,24,0,132,0,157,157
2020-03-27,MD,774,94,0,0,0,0,25,2020-03-27T20:00:00Z,5,868,868,868,24,1,41,0,194,194
2020-03-28,MD,992,11516,0,0,0,0,25,2020-03-28T20:00:00Z,5,12508,12508,12508,24,0,53,11422,218,11640
2020-03-29,MD,1239,12354,0,0,0,0,0,2020-03-29T20:00:00Z,10,13593,13593,13593,24,5,51,838,247,1085
2020-03-30,MD,1413,13316,0,0,0,0,0,2020-03-30T20:00:00Z,15,14729,14729,14729,24,5,76,962,174,1136
2020-03-31,MD,1660,14868,0,0,0,0,0,2020-03-31T20:00:00Z,18,16528,16528,16528,24,3,76,1552,247,1799
2020-04-01,MD,1985,17233,0,0,0,0,0,2020-04-01T20:00:00Z,31,19218,19218,19218,24,13,93,2365,325,2690
2020-04-02,MD,2331,18890,0,0,0,0,81,2020-04-02T20:00:00Z,36,21221,21221,21221,24,5,60,1657,346,2003
2020-04-03,MD,2758,20932,0,0,0,0,159,2020-04-03T20:00:00Z,42,23690,23690,23690,24,6,82,2042,427,2469
2020-04-04,MD,3125,22485,0,0,0,0,159,2020-04-04T20:00:00Z,53,25610,25610,25610,24,11,157,1553,367,1920
2020-04-05,MD,3609,24728,0,0,0,0,159,2020-04-05T20:00:00Z,67,28337,28337,28337,24,14,115,2243,484,2727
2020-04-06,MD,4045,25572,0,0,0,0,184,2020-04-06T20:00:00Z,91,29617,29617,29617,24,24,123,844,436,1280
2020-03-07,ME,0,1,0,0,0,0,0,2020-03-07T21:00:00Z,0,1,1,1,23,0,0,0,0,0
2020-03-08,ME,0,1,0,0,0,0,0,2020-03-08T20:00:00Z,0,1,1,1,23,0,0,0,0,0
2020-03-09,ME,0,1,0,0,0,0,0,2020-03-09T20:00:00Z,0,1,1,1,23,0,0,0,0,0
2020-03-10,ME,0,20,5,0,0,0,0,2020-03-10T20:00:00Z,0,25,20,20,23,0,0,19,0,19
2020-03-11,ME,0,42,5,0,0,0,0,2020-03-11T20:00:00Z,0,47,42,42,23,0,0,22,0,22
2020-03-12,ME,1,65,20,0,0,0,0,2020-03-12T20:00:00Z,0,86,66,66,23,0,0,23,1,24
2020-03-13,ME,3,91,17,0,0,0,0,2020-03-13T20:00:00Z,0,111,94,94,23,0,0,26,2,28
2020-03-14,ME,3,91,17,0,0,0,0,2020-03-14T20:00:00Z,0,111,94,94,23,0,0,0,0,0
2020-03-15,ME,3,91,17,0,0,0,0,2020-03-15T20:00:00Z,0,111,94,94,23,0,0,0,0,0
2020-03-16,ME,17,764,0,0,0,0,0,2020-03-16T20:00:00Z,0,781,781,781,23,0,0,673,14,687
2020-03-17,ME,32,1303,0,0,0,0,0,2020-03-17T20:00:00Z,0,1335,1335,1335,23,0,0,539,15,554
2020-03-18,ME,43,1670,0,0,0,0,0,2020-03-18T20:00:00Z,0,1713,1713,1713,23,0,0,367,11,378
2020-03-19,ME,53,2004,0,0,0,0,0,2020-03-19T20:00:00Z,0,2057,2057,2057,23,0,0,334,10,344
2020-03-20,ME,57,2264,0,0,0,0,0,2020-03-20T20:00:00Z,0,2321,2321,2321,23,0,0,260,4,264
2020-03-21,ME,73,2264,0,0,0,0,0,2020-03-21T20:00:00Z,0,2337,2337,2337,23,0,0,0,16,16
2020-03-22,ME,89,2264,0,0,0,0,0,2020-03-22T20:00:00Z,0,2353,2353,2353,23,0,0,0,16,16
2020-03-23,ME,107,2791,0,0,0,0,0,2020-03-23T20:00:00Z,0,2898,2898,2898,23,0,0,527,18,545
2020-03-24,ME,125,3014,0,0,0,0,0,2020-03-24T20:00:00Z,0,3139,3139,3139,23,0,0,223,18,241
2020-03-25,ME,149,3177,0,0,0,0,7,2020-03-25T20:00:00Z,0,3326,3326,3326,23,0,0,163,24,187
2020-03-26,ME,155,3394,0,0,0,0,16,2020-03-26T20:00:00Z,0,3549,3549,3549,23,0,0,217,6,223
2020-03-27,ME,168,3394,0,0,0,0,24,2020-03-27T20:00:00Z,1,3562,3562,3562,23,1,0,0,13,13
2020-03-28,ME,211,3394,0,0,0,0,36,2020-03-28T20:00:00Z,1,3605,3605,3605,23,0,0,0,43,43
2020-03-29,ME,253,3394,0,0,0,0,41,2020-03-29T20:00:00Z,3,3647,3647,3647,23,2,0,0,42,42
2020-03-30,ME,275,3394,0,0,0,0,41,2020-03-30T20:00:00Z,3,3669,3669,3669,23,0,49,0,22,22
2020-03-31,ME,303,6088,0,0,0,0,68,2020-03-31T20:00:00Z,5,6391,6391,6391,23,2,8,2694,28,2722
2020-04-01,ME,344,6088,0,0,0,0,80,2020-04-01T20:00:00Z,7,6432,6432,6432,23,2,6,0,41,41
2020-04-02,ME,376,6088,0,0,0,0,94,2020-04-02T20:00:00Z,7,6464,6464,6464,23,0,5,0,32,32
2020-04-03,ME,432,6088,0,0,0,0,113,2020-04-03T20:00:00Z,9,6520,6520,6520,23,2,7,0,56,56
2020-04-04,ME,456,6088,0,0,0,0,140,2020-04-04T20:00:00Z,10,6544,6544,6544,23,1,8,0,24,24
2020-04-05,ME,470,6088,0,0,0,0,156,2020-04-05T20:00:00Z,10,6558,6558,6558,23,0,3,0,14,14
2020-04-06,ME,499,6088,0,0,0,0,158,2020-04-06T20:00:00Z,10,6587,6587,6587,23,0,6,0,29,29
2020-03-05,MI,0,8,0,0,0,0,0,2020-03-05T21:00:00Z,0,8,8,8,26,0,0,0,0,0
2020-03-06,MI,0,8,8,0,0,0,0,2020-03-06T21:00:00Z,0,16,8,8,26,0,0,0,0,0
2020-03-07,MI,0,18,9,0,0,0,0,2020-03-07T21:00:00Z,0,27,18,18,26,0,0,10,0,10
2020-03-08,MI,0,26,10,0,0,0,0,2020-03-08T20:00:00Z,0,36,26,26,26,0,0,8,0,8
2020-03-09,MI,0,36,11,0,0,0,0,2020-03-09T20:00:00Z,0,47,36,36,26,0,0,10,0,10
2020-03-10,MI,0,39,24,0,0,0,0,2020-03-10T20:00:00Z,0,63,39,39,26,0,0,3,0,3
2020-03-11,MI,2,57,18,0,0,0,0,2020-03-11T20:00:00Z,0,77,59,59,26,0,0,18,2,20
2020-03-12,MI,2,91,27,0,0,0,0,2020-03-12T20:00:00Z,0,120,93,93,26,0,0,34,0,34
2020-03-13,MI,16,133,26,0,0,0,0,2020-03-13T20:00:00Z,0,175,149,149,26,0,0,42,14,56
2020-03-14,MI,25,205,26,0,0,0,0,2020-03-14T20:00:00Z,0,256,230,230,26,0,0,72,9,81
2020-03-15,MI,33,205,26,0,0,0,0,2020-03-15T20:00:00Z,0,264,238,238,26,0,0,0,8,8
2020-03-16,MI,53,272,30,0,0,0,0,2020-03-16T20:00:00Z,0,355,325,325,26,0,0,67,20,87
2020-03-17,MI,65,272,0,0,0,0,0,2020-03-17T20:00:00Z,0,337,337,337,26,0,0,0,12,12
2020-03-18,MI,80,272,0,0,0,0,0,2020-03-18T20:00:00Z,0,352,352,352,26,0,0,0,15,15
2020-03-19,MI,336,2113,0,0,0,0,0,2020-03-19T20:00:00Z,3,2449,2449,2449,26,3,0,1841,256,2097
2020-03-20,MI,549,2113,0,0,0,0,0,2020-03-20T20:00:00Z,3,2618,2618,2618,26,0,0,-44,213,169
2020-03-21,MI,787,2069,0,0,0,0,0,2020-03-21T20:00:00Z,5,2856,2856,2856,26,2,0,0,238,238
2020-03-22,MI,1035,2069,0,0,0,0,0,2020-03-22T20:00:00Z,8,3104,3104,3104,26,3,0,0,248,248
2020-03-23,MI,1328,2069,0,0,0,0,0,2020-03-23T20:00:00Z,15,3397,3397,3397,26,7,0,0,293,293
2020-03-24,MI,1791,2069,0,0,0,0,0,2020-03-24T20:00:00Z,24,3860,3860,3860,26,9,0,0,463,463
2020-03-25,MI,2294,2069,0,0,0,0,0,2020-03-25T20:00:00Z,43,4363,4363,4363,26,19,0,0,503,503
2020-03-26,MI,2856,6550,0,0,0,0,0,2020-03-26T20:00:00Z,60,9406,9406,9406,26,17,0,4481,562,5043
2020-03-27,MI,3657,6550,0,0,0,0,0,2020-03-27T20:00:00Z,92,10207,10207,10207,26,32,0,0,801,801
2020-03-28,MI,3657,9109,0,0,0,0,0,2020-03-28T20:00:00Z,92,12766,12766,12766,26,0,0,2559,0,2559
2020-03-29,MI,5486,11893,0,0,0,0,0,2020-03-29T20:00:00Z,132,17379,17379,17379,26,40,0,2784,1829,4613
2020-03-30,MI,6498,11893,0,0,0,0,0,2020-03-30T20:00:00Z,184,18391,18391,18391,26,52,0,0,1012,1012
2020-03-31,MI,7615,11893,0,0,0,0,0,2020-03-31T20:00:00Z,259,19508,19508,19508,26,75,0,0,1117,1117
2020-04-01,MI,9334,11893,0,0,0,0,0,2020-04-01T20:00:00Z,337,21227,21227,21227,26,78,0,0,1719,1719
2020-04-02,MI,10791,11893,0,0,0,0,0,2020-04-02T20:00:00Z,417,22684,22684,22684,26,80,0,0,1457,1457
2020-04-03,MI,12744,11893,0,0,0,0,0,2020-04-03T20:00:00Z,479,24637,24637,24637,26,62,0,0,1953,1953
2020-04-04,MI,14225,11893,0,0,0,0,0,2020-04-04T20:00:00Z,540,26118,26118,26118,26,61,0,0,1481,1481
2020-04-05,MI,15718,30030,0,0,0,0,0,2020-04-05T20:00:00Z,617,45748,45748,45748,26,77,0,18137,1493,19630
2020-04-06,MI,17221,30030,0,0,0,0,0,2020-04-06T20:00:00Z,727,47251,47251,47251,26,110,0,0,1503,1503
2020-03-06,MN,0,36,0,0,0,0,0,2020-03-06T21:00:00Z,0,36,36,36,27,0,0,0,0,0
2020-03-07,MN,1,48,0,0,0,0,0,2020-03-07T21:00:00Z,0,49,49,49,27,0,0,12,1,13
2020-03-08,MN,1,48,0,0,0,0,0,2020-03-08T20:00:00Z,0,49,49,49,27,0,0,0,0,0
2020-03-09,MN,2,80,0,0,0,0,0,2020-03-09T20:00:00Z,0,82,82,82,27,0,0,32,1,33
2020-03-10,MN,3,132,0,0,0,0,0,2020-03-10T20:00:00Z,0,135,135,135,27,0,0,52,1,53
2020-03-11,MN,5,217,0,0,0,0,0,2020-03-11T20:00:00Z,0,222,222,222,27,0,0,85,2,87
2020-03-12,MN,9,307,0,0,0,0,0,2020-03-12T20:00:00Z,0,316,316,316,27,0,0,90,4,94
2020-03-13,MN,14,541,0,0,0,0,0,2020-03-13T20:00:00Z,0,555,555,555,27,0,0,234,5,239
2020-03-14,MN,21,847,0,0,0,0,0,2020-03-14T20:00:00Z,0,868,868,868,27,0,0,306,7,313
2020-03-15,MN,35,1387,0,0,0,0,0,2020-03-15T20:00:00Z,0,1422,1422,1422,27,0,0,540,14,554
2020-03-16,MN,54,1839,0,0,0,0,0,2020-03-16T20:00:00Z,0,1893,1893,1893,27,0,0,452,19,471
2020-03-17,MN,60,2276,0,0,0,0,0,2020-03-17T20:00:00Z,0,2336,2336,2336,27,0,0,437,6,443
2020-03-18,MN,77,2685,0,0,0,0,0,2020-03-18T20:00:00Z,0,2762,2762,2762,27,0,0,409,17,426
2020-03-19,MN,89,2949,0,0,0,0,0,2020-03-19T20:00:00Z,0,3038,3038,3038,27,0,0,264,12,276
2020-03-20,MN,115,3741,0,0,0,0,0,2020-03-20T20:00:00Z,0,3856,3856,3856,27,0,0,792,26,818
2020-03-21,MN,138,3952,0,0,0,0,0,2020-03-21T20:00:00Z,1,4090,4090,4090,27,1,0,211,23,234
2020-03-22,MN,169,4511,0,0,0,0,0,2020-03-22T20:00:00Z,1,4680,4680,4680,27,0,12,559,31,590
2020-03-23,MN,235,4511,0,0,0,0,0,2020-03-23T20:00:00Z,1,4746,4746,4746,27,0,5,0,66,66
2020-03-24,MN,262,5550,0,0,0,0,0,2020-03-24T20:00:00Z,1,5812,5812,5812,27,0,4,1039,27,1066
2020-03-25,MN,287,11188,0,26,0,0,122,2020-03-25T20:00:00Z,1,11475,11475,11475,27,0,14,5638,25,5663
2020-03-26,MN,346,12604,0,31,0,0,122,2020-03-26T20:00:00Z,2,12950,12950,12950,27,1,6,1416,59,1475
2020-03-27,MN,398,13605,0,34,0,0,180,2020-03-27T20:00:00Z,4,14003,14003,14003,27,2,10,1001,52,1053
2020-03-28,MN,441,15688,0,30,0,0,220,2020-03-28T20:00:00Z,5,16129,16129,16129,27,1,6,2083,43,2126
2020-03-29,MN,503,17154,0,39,0,0,252,2020-03-29T20:00:00Z,9,17657,17657,17657,27,4,18,1466,62,1528
2020-03-30,MN,576,18246,0,56,24,0,252,2020-03-30T20:00:00Z,10,18822,18822,18822,27,1,17,1092,73,1165
2020-03-31,MN,629,19151,0,56,26,0,0,2020-03-31T20:00:00Z,12,19780,19780,19780,27,2,20,905,53,958
2020-04-01,MN,689,20502,0,54,27,0,0,2020-04-01T20:00:00Z,17,21191,21191,21191,27,5,10,1351,60,1411
2020-04-02,MN,742,21652,0,75,38,0,0,2020-04-02T20:00:00Z,18,22394,22394,22394,27,1,16,1150,53,1203
2020-04-03,MN,789,23438,0,86,40,0,0,2020-04-03T20:00:00Z,22,24227,24227,24227,27,4,18,1786,47,1833
2020-04-04,MN,865,24558,0,95,42,0,440,2020-04-04T20:00:00Z,24,25423,25423,25423,27,2,24,1120,76,1196
2020-04-05,MN,935,25842,0,106,48,0,451,2020-04-05T20:00:00Z,29,26777,26777,26777,27,5,22,1284,70,1354
2020-04-06,MN,986,27142,0,115,57,0,470,2020-04-06T20:00:00Z,30,28128,28128,28128,27,1,21,1300,51,1351
2020-03-07,MO,0,0,0,0,0,0,0,2020-03-07T21:00:00Z,0,0,0,0,29,0,0,0,0,0
2020-03-08,MO,1,0,0,0,0,0,0,2020-03-08T20:00:00Z,0,1,1,1,29,0,0,0,1,1
2020-03-09,MO,1,0,0,0,0,0,0,2020-03-09T20:00:00Z,0,1,1,1,29,0,0,0,0,0
2020-03-10,MO,1,0,0,0,0,0,0,2020-03-10T20:00:00Z,0,1,1,1,29,0,0,0,0,0
2020-03-11,MO,1,0,0,0,0,0,0,2020-03-11T20:00:00Z,0,1,1,1,29,0,0,0,0,0
2020-03-12,MO,1,64,0,0,0,0,0,2020-03-12T20:00:00Z,0,65,65,65,29,0,0,64,0,64
2020-03-13,MO,2,71,0,0,0,0,0,2020-03-13T20:00:00Z,0,73,73,73,29,0,0,7,1,8
2020-03-14,MO,4,90,0,0,0,0,0,2020-03-14T20:00:00Z,0,94,94,94,29,0,0,19,2,21
2020-03-15,MO,5,122,0,0,0,0,0,2020-03-15T20:00:00Z,0,127,127,127,29,0,0,32,1,33
2020-03-16,MO,6,164,0,0,0,0,0,2020-03-16T20:00:00Z,0,170,170,170,29,0,0,42,1,43
2020-03-17,MO,8,207,0,0,0,0,0,2020-03-17T20:00:00Z,0,215,215,215,29,0,0,43,2,45
2020-03-18,MO,13,253,0,0,0,0,0,2020-03-18T20:00:00Z,0,266,266,266,29,0,0,46,5,51
2020-03-19,MO,24,308,0,0,0,0,0,2020-03-19T20:00:00Z,1,332,332,332,29,1,0,55,11,66
2020-03-20,MO,47,369,0,0,0,0,0,2020-03-20T20:00:00Z,1,416,416,416,29,0,0,61,23,84
2020-03-21,MO,73,369,0,0,0,0,0,2020-03-21T20:00:00Z,3,442,442,442,29,2,0,0,26,26
2020-03-22,MO,90,369,0,0,0,0,0,2020-03-22T20:00:00Z,3,459,459,459,29,0,0,0,17,17
2020-03-23,MO,183,369,0,0,0,0,0,2020-03-23T20:00:00Z,3,552,552,552,29,0,0,0,93,93
2020-03-24,MO,183,369,0,0,0,0,0,2020-03-24T20:00:00Z,3,552,552,552,29,0,0,0,0,0
2020-03-25,MO,356,369,0,0,0,0,0,2020-03-25T20:00:00Z,8,725,725,725,29,5,0,0,173,173
2020-03-26,MO,502,369,0,0,0,0,0,2020-03-26T20:00:00Z,8,871,871,871,29,0,0,0,146,146
2020-03-27,MO,669,369,0,0,0,0,0,2020-03-27T20:00:00Z,8,1038,1038,1038,29,0,0,0,167,167
2020-03-28,MO,838,10082,0,0,0,0,0,2020-03-28T20:00:00Z,10,10920,10920,10920,29,2,0,9713,169,9882
2020-03-29,MO,838,11547,0,0,0,0,0,2020-03-29T20:00:00Z,10,12385,12385,12385,29,0,0,1465,0,1465
2020-03-30,MO,1031,13204,0,0,0,0,0,2020-03-30T20:00:00Z,13,14235,14235,14235,29,3,0,1657,193,1850
2020-03-31,MO,1327,14614,0,0,0,0,0,2020-03-31T20:00:00Z,14,15941,15941,15941,29,1,0,1410,296,1706
2020-04-01,MO,1581,15846,0,0,0,0,0,2020-04-01T20:00:00Z,18,17427,17427,17427,29,4,0,1232,254,1486
2020-04-02,MO,1834,17849,0,0,0,0,0,2020-04-02T20:00:00Z,19,19683,19683,19683,29,1,0,2003,253,2256
2020-04-03,MO,2113,19357,0,0,0,0,0,2020-04-03T20:00:00Z,19,21470,21470,21470,29,0,0,1508,279,1787
2020-04-04,MO,2291,22614,0,413,0,0,0,2020-04-04T20:00:00Z,24,24905,24905,24905,29,5,0,3257,178,3435
2020-04-05,MO,2367,24882,0,424,0,0,0,2020-04-05T20:00:00Z,34,27249,27249,27249,29,10,0,2268,76,2344
2020-04-06,MO,2722,27113,0,439,0,0,0,2020-04-06T20:00:00Z,39,29835,29835,29835,29,5,0,2231,355,2586
2020-03-16,MP,0,0,0,0,0,0,0,2020-03-16T20:00:00Z,0,0,0,0,69,0,0,0,0,0
2020-03-17,MP,0,0,0,0,0,0,0,2020-03-17T20:00:00Z,0,0,0,0,69,0,0,0,0,0
2020-03-18,MP,0,0,0,0,0,0,0,2020-03-18T20:00:00Z,0,0,0,0,69,0,0,0,0,0
2020-03-19,MP,0,0,0,0,0,0,0,2020-03-19T20:00:00Z,0,0,0,0,69,0,0,0,0,0
2020-03-20,MP,0,0,0,0,0,0,0,2020-03-20T20:00:00Z,0,0,0,0,69,0,0,0,0,0
2020-03-21,MP,0,0,0,0,0,0,0,2020-03-21T20:00:00Z,0,0,0,0,69,0,0,0,0,0
2020-03-22,MP,0,0,0,0,0,0,0,2020-03-22T20:00:00Z,0,0,0,0,69,0,0,0,0,0
2020-03-23,MP,0,0,0,0,0,0,0,2020-03-23T20:00:00Z,0,0,0,0,69,0,0,0,0,0
2020-03-24,MP,0,0,0,0,0,0,0,2020-03-24T20:00:00Z,0,0,0,0,69,0,0,0,0,0
2020-03-25,MP,0,0,0,0,0,0,0,2020-03-25T20:00:00Z,0,0,0,0,69,0,0,0,0,0
2020-03-26,MP,0,0,0,0,0,0,0,2020-03-26T20:00:00Z,0,0,0,0,69,0,0,0,0,0
2020-03-27,MP,0,0,0,0,0,0,0,2020-03-27T20:00:00Z,0,0,0,0,69,0,0,0,0,0
2020-03-28,MP,2,0,0,0,0,0,0,2020-03-28T20:00:00Z,0,2,2,2,69,0,0,0,2,2
2020-03-29,MP,2,0,0,0,0,0,0,2020-03-29T20:00:00Z,0,2,2,2,69,0,0,0,0,0
2020-03-30,MP,2,0,0,0,0,0,0,2020-03-30T20:00:00Z,0,2,2,2,69,0,0,0,0,0
2020-03-31,MP,2,0,0,0,0,0,0,2020-03-31T20:00:00Z,0,2,2,2,69,0,0,0,0,0
2020-04-01,MP,6,0,0,0,0,0,0,2020-04-01T20:00:00Z,0,6,6,6,69,0,0,0,4,4
2020-04-02,MP,8,13,12,0,0,0,0,2020-04-02T20:00:00Z,1,33,21,21,69,1,0,13,2,15
2020-04-03,MP,8,13,10,0,0,0,0,2020-04-03T20:00:00Z,1,31,21,21,69,0,0,0,0,0
2020-04-04,MP,8,13,10,0,0,0,0,2020-04-04T20:00:00Z,1,31,21,21,69,0,0,0,0,0
2020-04-05,MP,8,13,10,0,0,0,0,2020-04-05T20:00:00Z,1,31,21,21,69,0,0,0,0,0
2020-04-06,MP,8,13,10,0,0,0,0,2020-04-06T20:00:00Z,1,31,21,21,69,0,0,0,0,0
2020-03-07,MS,0,0,0,0,0,0,0,2020-03-07T21:00:00Z,0,0,0,0,28,0,0,0,0,0
2020-03-08,MS,0,0,0,0,0,0,0,2020-03-08T20:00:00Z,0,0,0,0,28,0,0,0,0,0
2020-03-09,MS,0,0,0,0,0,0,0,2020-03-09T20:00:00Z,0,0,0,0,28,0,0,0,0,0
2020-03-10,MS,0,0,0,0,0,0,0,2020-03-10T20:00:00Z,0,0,0,0,28,0,0,0,0,0
2020-03-11,MS,0,20,0,0,0,0,0,2020-03-11T20:00:00Z,0,20,20,20,28,0,0,20,0,20
2020-03-12,MS,1,41,0,0,0,0,0,2020-03-12T20:00:00Z,0,42,42,42,28,0,0,21,1,22
2020-03-13,MS,4,41,0,0,0,0,0,2020-03-13T20:00:00Z,0,45,45,45,28,0,0,0,3,3
2020-03-14,MS,6,84,0,0,0,0,0,2020-03-14T20:00:00Z,0,90,90,90,28,0,0,43,2,45
2020-03-15,MS,10,84,0,0,0,0,0,2020-03-15T20:00:00Z,0,94,94,94,28,0,0,0,4,4
2020-03-16,MS,12,277,0,0,0,0,0,2020-03-16T20:00:00Z,0,289,289,289,28,0,0,193,2,195
2020-03-17,MS,21,368,0,0,0,0,0,2020-03-17T20:00:00Z,0,389,389,389,28,0,0,91,9,100
2020-03-18,MS,34,479,0,0,0,0,0,2020-03-18T20:00:00Z,0,513,513,513,28,0,0,111,13,124
2020-03-19,MS,50,552,0,0,0,0,0,2020-03-19T20:00:00Z,0,602,602,602,28,0,0,73,16,89
2020-03-20,MS,80,695,0,0,0,0,0,2020-03-20T20:00:00Z,1,775,775,775,28,1,0,143,30,173
2020-03-21,MS,140,695,0,0,0,0,0,2020-03-21T20:00:00Z,1,835,835,835,28,0,0,0,60,60
2020-03-22,MS,207,1114,0,0,0,0,0,2020-03-22T20:00:00Z,1,1321,1321,1321,28,0,33,419,67,486
2020-03-23,MS,249,1143,0,0,0,0,0,2020-03-23T20:00:00Z,1,1392,1392,1392,28,0,0,29,42,71
2020-03-24,MS,320,1552,0,0,0,0,0,2020-03-24T20:00:00Z,1,1872,1872,1872,28,0,53,409,71,480
2020-03-25,MS,377,1566,0,0,0,0,0,2020-03-25T20:00:00Z,2,1943,1943,1943,28,1,31,14,57,71
2020-03-26,MS,485,2291,0,0,0,0,0,2020-03-26T20:00:00Z,6,2776,2776,2776,28,4,33,725,108,833
2020-03-27,MS,579,2560,0,0,0,0,0,2020-03-27T20:00:00Z,8,3139,3139,3139,28,2,35,269,94,363
2020-03-28,MS,663,2560,0,0,0,0,0,2020-03-28T20:00:00Z,13,3223,3223,3223,28,5,34,0,84,84
2020-03-29,MS,758,2560,0,0,0,0,0,2020-03-29T20:00:00Z,14,3318,3318,3318,28,1,16,0,95,95
2020-03-30,MS,847,2989,0,0,0,0,0,2020-03-30T20:00:00Z,16,3836,3836,3836,28,2,-40,429,89,518
2020-03-31,MS,937,3537,0,0,0,0,0,2020-03-31T20:00:00Z,20,4474,4474,4474,28,4,16,548,90,638
2020-04-01,MS,1073,3712,0,0,0,0,0,2020-04-01T20:00:00Z,22,4785,4785,4785,28,2,121,175,136,311
2020-04-02,MS,1177,4753,0,0,0,0,0,2020-04-02T20:00:00Z,26,5930,5930,5930,28,4,28,1041,104,1145
2020-04-03,MS,1358,4753,0,0,0,0,0,2020-04-03T20:00:00Z,29,6111,6111,6111,28,3,60,0,181,181
2020-04-04,MS,1455,5133,0,0,0,0,0,2020-04-04T20:00:00Z,35,6588,6588,6588,28,6,16,380,97,477
2020-04-05,MS,1638,5580,0,0,0,0,0,2020-04-05T20:00:00Z,43,7218,7218,7218,28,8,39,447,183,630
2020-04-06,MS,1738,18632,0,0,0,0,0,2020-04-06T20:00:00Z,51,20370,20370,20370,28,8,0,13052,100,13152
2020-03-07,MT,0,11,0,0,0,0,0,2020-03-07T21:00:00Z,0,11,11,11,30,0,0,0,0,0
2020-03-08,MT,0,11,0,0,0,0,0,2020-03-08T20:00:00Z,0,11,11,11,30,0,0,0,0,0
2020-03-09,MT,0,11,0,0,0,0,0,2020-03-09T20:00:00Z,0,11,11,11,30,0,0,0,0,0
2020-03-10,MT,0,15,0,0,0,0,0,2020-03-10T20:00:00Z,0,15,15,15,30,0,0,4,0,4
2020-03-11,MT,0,21,0,0,0,0,0,2020-03-11T20:00:00Z,0,21,21,21,30,0,0,6,0,6
2020-03-12,MT,1,34,0,0,0,0,0,2020-03-12T20:00:00Z,0,35,35,35,30,0,0,13,1,14
2020-03-13,MT,1,55,0,0,0,0,0,2020-03-13T20:00:00Z,0,56,56,56,30,0,0,21,0,21
2020-03-14,MT,5,103,0,0,0,0,0,2020-03-14T20:00:00Z,0,108,108,108,30,0,0,48,4,52
2020-03-15,MT,7,103,57,0,0,0,0,2020-03-15T20:00:00Z,0,167,110,110,30,0,0,0,2,2
2020-03-16,MT,7,198,0,0,0,0,0,2020-03-16T20:00:00Z,0,205,205,205,30,0,0,95,0,95
2020-03-17,MT,8,303,0,0,0,0,0,2020-03-17T20:00:00Z,0,311,311,311,30,0,0,105,1,106
2020-03-18,MT,10,499,0,0,0,0,0,2020-03-18T20:00:00Z,0,509,509,509,30,0,0,196,2,198
2020-03-19,MT,12,761,0,0,0,0,0,2020-03-19T20:00:00Z,0,773,773,773,30,0,0,262,2,264
2020-03-20,MT,16,931,0,0,0,0,0,2020-03-20T20:00:00Z,0,947,947,947,30,0,0,170,4,174
2020-03-21,MT,20,1146,0,0,0,0,0,2020-03-21T20:00:00Z,0,1166,1166,1166,30,0,0,215,4,219
2020-03-22,MT,31,1146,0,0,0,0,0,2020-03-22T20:00:00Z,0,1177,1177,1177,30,0,0,0,11,11
2020-03-23,MT,34,1146,0,0,0,0,0,2020-03-23T20:00:00Z,0,1180,1180,1180,30,0,0,0,3,3
2020-03-24,MT,46,1643,0,0,0,0,0,2020-03-24T20:00:00Z,0,1689,1689,1689,30,0,0,497,12,509
2020-03-25,MT,53,1948,0,0,0,0,0,2020-03-25T20:00:00Z,0,2001,2001,2001,30,0,0,305,7,312
2020-03-26,MT,71,2128,0,0,0,0,0,2020-03-26T20:00:00Z,0,2199,2199,2199,30,0,1,180,18,198
2020-03-27,MT,108,2590,0,0,0,0,0,2020-03-27T20:00:00Z,0,2698,2698,2698,30,0,6,462,37,499
2020-03-28,MT,129,3256,0,0,0,0,0,2020-03-28T20:00:00Z,1,3385,3385,3385,30,1,0,666,21,687
2020-03-29,MT,154,4143,0,0,0,0,0,2020-03-29T20:00:00Z,1,4297,4297,4297,30,0,1,887,25,912
2020-03-30,MT,171,4143,0,0,0,0,0,2020-03-30T20:00:00Z,4,4132,4297,4297,30,3,2,-182,17,-165
2020-03-31,MT,184,4234,0,0,0,0,0,2020-03-31T20:00:00Z,4,4418,4418,4418,30,0,4,273,13,286
2020-04-01,MT,208,4710,0,0,0,0,0,2020-04-01T20:00:00Z,5,4918,4918,4918,30,1,3,476,24,500
2020-04-02,MT,227,5093,0,0,0,0,0,2020-04-02T20:00:00Z,5,5320,5320,5320,30,0,3,383,19,402
2020-04-03,MT,243,5333,0,0,0,0,0,2020-04-03T20:00:00Z,5,5576,5576,5576,30,0,4,240,16,256
2020-04-04,MT,265,5912,0,0,0,0,0,2020-04-04T20:00:00Z,5,6177,6177,6177,30,0,0,579,22,601
2020-04-05,MT,286,6317,0,0,0,0,0,2020-04-05T20:00:00Z,6,6603,6603,6603,30,1,0,405,21,426
2020-04-06,MT,299,6491,0,0,0,0,0,2020-04-06T20:00:00Z,6,6790,6790,6790,30,0,0,174,13,187
2020-03-04,NC,1,0,0,0,0,0,0,2020-03-04T21:00:00Z,0,1,1,1,37,0,0,0,0,0
2020-03-05,NC,1,0,0,0,0,0,0,2020-03-05T21:00:00Z,0,1,1,1,37,0,0,0,0,0
2020-03-06,NC,2,0,0,0,0,0,0,2020-03-06T21:00:00Z,0,2,2,2,37,0,0,0,1,1
2020-03-07,NC,2,0,0,0,0,0,0,2020-03-07T21:00:00Z,0,2,2,2,37,0,0,0,0,0
2020-03-08,NC,2,0,0,0,0,0,0,2020-03-08T20:00:00Z,0,2,2,2,37,0,0,0,0,0
2020-03-09,NC,2,0,0,0,0,0,0,2020-03-09T20:00:00Z,0,2,2,2,37,0,0,0,0,0
2020-03-10,NC,7,0,0,0,0,0,0,2020-03-10T20:00:00Z,0,7,7,7,37,0,0,0,5,5
2020-03-11,NC,7,0,0,0,0,0,0,2020-03-11T20:00:00Z,0,7,7,7,37,0,0,0,0,0
2020-03-12,NC,12,60,0,0,0,0,0,2020-03-12T20:00:00Z,0,72,72,72,37,0,0,60,5,65
2020-03-13,NC,15,86,0,0,0,0,0,2020-03-13T20:00:00Z,0,101,101,101,37,0,0,26,3,29
2020-03-14,NC,23,137,0,0,0,0,0,2020-03-14T20:00:00Z,0,160,160,160,37,0,0,51,8,59
2020-03-15,NC,32,227,151,0,0,0,0,2020-03-15T20:00:00Z,0,410,259,259,37,0,0,90,9,99
2020-03-16,NC,33,296,151,0,0,0,0,2020-03-16T20:00:00Z,0,480,329,329,37,0,0,69,1,70
2020-03-17,NC,40,474,0,0,0,0,0,2020-03-17T20:00:00Z,0,514,514,514,37,0,0,178,7,185
2020-03-18,NC,63,1787,0,0,0,0,0,2020-03-18T20:00:00Z,0,1850,1850,1850,37,0,0,1313,23,1336
2020-03-19,NC,97,2408,0,0,0,0,0,2020-03-19T20:00:00Z,0,2505,2505,2505,37,0,0,621,34,655
2020-03-20,NC,137,3096,0,0,0,0,0,2020-03-20T20:00:00Z,0,3233,3233,3233,37,0,0,688,40,728
2020-03-21,NC,184,5092,0,0,0,0,0,2020-03-21T20:00:00Z,0,5276,5276,5276,37,0,0,1996,47,2043
2020-03-22,NC,255,6183,0,0,0,0,0,2020-03-22T20:00:00Z,0,6438,6438,6438,37,0,0,1091,71,1162
2020-03-23,NC,297,8141,0,0,0,0,0,2020-03-23T20:00:00Z,0,8438,8438,8438,37,0,0,1958,42,2000
2020-03-24,NC,398,8141,0,0,0,0,0,2020-03-24T20:00:00Z,0,8539,8539,8539,37,0,0,0,101,101
2020-03-25,NC,504,9985,0,29,0,0,0,2020-03-25T20:00:00Z,1,10489,10489,10489,37,1,29,1844,106,1950
2020-03-26,NC,636,12274,0,29,0,0,0,2020-03-26T20:00:00Z,2,12910,12910,12910,37,1,0,2289,132,2421
2020-03-27,NC,763,14373,0,77,0,0,0,2020-03-27T20:00:00Z,3,15136,15136,15136,37,1,48,2099,127,2226
2020-03-28,NC,935,16592,0,87,0,0,0,2020-03-28T20:00:00Z,4,17527,17527,17527,37,1,10,2219,172,2391
2020-03-29,NC,1040,17905,0,91,0,0,0,2020-03-29T20:00:00Z,4,18945,18945,18945,37,0,4,1313,105,1418
2020-03-30,NC,1307,19557,0,137,0,0,0,2020-03-30T20:00:00Z,6,20864,20864,20864,37,2,46,1652,267,1919
2020-03-31,NC,1498,21608,0,157,0,0,0,2020-03-31T20:00:00Z,8,23106,23106,23106,37,2,20,2051,191,2242
2020-04-01,NC,1584,24659,0,204,0,0,0,2020-04-01T20:00:00Z,10,26243,26243,26243,37,2,47,3051,86,3137
2020-04-02,NC,1857,26822,0,184,0,0,0,2020-04-02T20:00:00Z,16,28679,28679,28679,37,6,0,2163,273,2436
2020-04-03,NC,2093,29505,0,184,0,0,0,2020-04-03T20:00:00Z,19,31598,31598,31598,37,3,55,2683,236,2919
2020-04-04,NC,2402,36371,0,271,0,0,0,2020-04-04T20:00:00Z,24,38773,38773,38773,37,5,0,6866,309,7175
2020-04-05,NC,2585,37460,0,261,0,0,0,2020-04-05T20:00:00Z,31,40045,40045,40045,37,7,0,1089,183,1272
2020-04-06,NC,2870,37856,0,270,0,0,0,2020-04-06T20:00:00Z,33,40726,40726,40726,37,2,0,396,285,681
2020-03-07,ND,0,0,0,0,0,0,0,2020-03-07T21:00:00Z,0,0,0,0,38,0,0,0,0,0
2020-03-08,ND,0,0,0,0,0,0,0,2020-03-08T20:00:00Z,0,0,0,0,38,0,0,0,0,0
2020-03-09,ND,0,0,0,0,0,0,0,2020-03-09T20:00:00Z,0,0,0,0,38,0,0,0,0,0
2020-03-10,ND,0,6,2,0,0,0,0,2020-03-10T20:00:00Z,0,8,6,6,38,0,0,6,0,6
2020-03-11,ND,0,7,6,0,0,0,0,2020-03-11T20:00:00Z,0,13,7,7,38,0,0,1,0,1
2020-03-12,ND,1,12,14,0,0,0,0,2020-03-12T20:00:00Z,0,27,13,13,38,0,0,5,1,6
2020-03-13,ND,1,39,12,0,0,0,0,2020-03-13T20:00:00Z,0,52,40,40,38,0,0,27,0,27
2020-03-14,ND,1,54,14,0,0,0,0,2020-03-14T20:00:00Z,0,69,55,55,38,0,0,15,0,15
2020-03-15,ND,1,95,4,0,0,0,0,2020-03-15T20:00:00Z,0,100,96,96,38,0,0,41,0,41
2020-03-16,ND,1,123,0,0,0,0,0,2020-03-16T20:00:00Z,0,124,124,124,38,0,0,28,0,28
2020-03-17,ND,3,220,0,0,0,0,0,2020-03-17T20:00:00Z,0,223,223,223,38,0,0,97,2,99
2020-03-18,ND,6,268,0,0,0,0,0,2020-03-18T20:00:00Z,0,274,274,274,38,0,0,48,3,51
2020-03-19,ND,15,493,0,0,0,0,0,2020-03-19T20:00:00Z,0,508,508,508,38,0,0,225,9,234
2020-03-20,ND,20,800,0,0,0,0,0,2020-03-20T20:00:00Z,0,820,820,820,38,0,0,307,5,312
2020-03-21,ND,28,1141,0,0,0,0,0,2020-03-21T20:00:00Z,0,1169,1169,1169,38,0,3,341,8,349
2020-03-22,ND,28,1260,0,0,0,0,0,2020-03-22T20:00:00Z,0,1288,1288,1288,38,0,0,119,0,119
2020-03-23,ND,30,1353,0,0,0,0,0,2020-03-23T20:00:00Z,0,1383,1383,1383,38,0,1,93,2,95
2020-03-24,ND,34,1454,0,0,0,0,0,2020-03-24T20:00:00Z,0,1488,1488,1488,38,0,1,101,4,105
2020-03-25,ND,39,1734,0,0,0,0,0,2020-03-25T20:00:00Z,0,1773,1773,1773,38,0,3,280,5,285
2020-03-26,ND,52,2039,0,0,0,0,0,2020-03-26T20:00:00Z,0,2091,2091,2091,38,0,2,305,13,318
2020-03-27,ND,65,2427,0,0,0,0,15,2020-03-27T20:00:00Z,0,2492,2492,2492,38,0,3,388,13,401
2020-03-28,ND,83,2809,0,0,0,0,16,2020-03-28T20:00:00Z,1,2892,2892,2892,38,1,3,382,18,400
2020-03-29,ND,98,3355,0,0,0,0,18,2020-03-29T20:00:00Z,1,3453,3453,3453,38,0,1,546,15,561
2020-03-30,ND,109,3728,0,0,0,0,19,2020-03-30T20:00:00Z,2,3837,3837,3837,38,1,2,373,11,384
2020-03-31,ND,126,4131,0,21,0,0,30,2020-03-31T20:00:00Z,3,4257,4257,4257,38,1,2,403,17,420
2020-04-01,ND,142,4351,0,23,0,0,34,2020-04-01T20:00:00Z,3,4493,4493,4493,38,0,2,220,16,236
2020-04-02,ND,159,4821,0,0,0,0,43,2020-04-02T20:00:00Z,3,4980,4980,4980,38,0,5,470,17,487
2020-04-03,ND,173,5625,0,0,0,0,55,2020-04-03T20:00:00Z,3,5798,5798,5798,38,0,1,804,14,818
2020-04-04,ND,186,6021,0,0,0,0,63,2020-04-04T20:00:00Z,3,6207,6207,6207,38,0,1,396,13,409
2020-04-05,ND,207,6580,0,20,0,0,63,2020-04-05T20:00:00Z,3,6787,6787,6787,38,0,1,559,21,580
2020-04-06,ND,225,6988,0,19,0,0,74,2020-04-06T20:00:00Z,3,7213,7213,7213,38,0,1,408,18,426
2020-03-05,NE,0,17,5,0,0,0,0,2020-03-05T21:00:00Z,0,22,17,17,31,0,0,0,0,0
2020-03-06,NE,0,17,5,0,0,0,0,2020-03-06T21:00:00Z,0,22,17,17,31,0,0,0,0,0
2020-03-07,NE,1,17,5,0,0,0,0,2020-03-07T21:00:00Z,0,23,18,18,31,0,0,0,1,1
2020-03-08,NE,1,17,5,0,0,0,0,2020-03-08T20:00:00Z,0,23,18,18,31,0,0,0,0,0
2020-03-09,NE,3,36,9,0,0,0,0,2020-03-09T20:00:00Z,0,48,39,39,31,0,0,19,2,21
2020-03-10,NE,3,47,16,0,0,0,0,2020-03-10T20:00:00Z,0,66,50,50,31,0,0,11,0,11
2020-03-11,NE,5,47,16,0,0,0,0,2020-03-11T20:00:00Z,0,68,52,52,31,0,0,0,2,2
2020-03-12,NE,10,80,33,0,0,0,0,2020-03-12T20:00:00Z,0,123,90,90,31,0,0,33,5,38
2020-03-13,NE,13,80,33,0,0,0,0,2020-03-13T20:00:00Z,0,126,93,93,31,0,0,0,3,3
2020-03-14,NE,14,80,33,0,0,0,0,2020-03-14T20:00:00Z,0,127,94,94,31,0,0,0,1,1
2020-03-15,NE,17,80,33,0,0,0,0,2020-03-15T20:00:00Z,0,130,97,97,31,0,0,0,3,3
2020-03-16,NE,18,170,0,0,0,0,0,2020-03-16T20:00:00Z,0,188,188,188,31,0,0,90,1,91
2020-03-17,NE,21,206,0,0,0,0,0,2020-03-17T20:00:00Z,0,227,227,227,31,0,0,36,3,39
2020-03-18,NE,24,206,0,0,0,0,0,2020-03-18T20:00:00Z,0,230,230,230,31,0,0,0,3,3
2020-03-19,NE,27,240,0,0,0,0,0,2020-03-19T20:00:00Z,0,267,267,267,31,0,0,34,3,37
2020-03-20,NE,32,240,0,0,0,0,0,2020-03-20T20:00:00Z,0,272,272,272,31,0,0,0,5,5
2020-03-21,NE,38,356,0,0,0,0,0,2020-03-21T20:00:00Z,0,394,394,394,31,0,0,116,6,122
2020-03-22,NE,48,356,0,0,0,0,0,2020-03-22T20:00:00Z,0,404,404,404,31,0,0,0,10,10
2020-03-23,NE,50,356,0,0,0,0,0,2020-03-23T20:00:00Z,0,406,406,406,31,0,0,0,2,2
2020-03-24,NE,52,975,0,0,0,0,0,2020-03-24T20:00:00Z,0,1027,1027,1027,31,0,0,619,2,621
2020-03-25,NE,61,1304,0,0,0,0,0,2020-03-25T20:00:00Z,0,1365,1365,1365,31,0,0,329,9,338
2020-03-26,NE,73,1584,0,0,0,0,0,2020-03-26T20:00:00Z,0,1657,1657,1657,31,0,0,280,12,292
2020-03-27,NE,85,1761,0,0,0,0,0,2020-03-27T20:00:00Z,0,1846,1846,1846,31,0,0,177,12,189
2020-03-28,NE,96,1904,0,0,0,0,0,2020-03-28T20:00:00Z,2,2000,2000,2000,31,2,0,143,11,154
2020-03-29,NE,108,1968,4,0,0,0,0,2020-03-29T20:00:00Z,2,2080,2076,2076,31,0,0,64,12,76
2020-03-30,NE,145,2584,5,0,0,0,0,2020-03-30T20:00:00Z,2,2734,2729,2729,31,0,0,616,37,653
2020-03-31,NE,172,2931,8,0,0,0,0,2020-03-31T20:00:00Z,3,3111,3103,3103,31,1,0,347,27,374
2020-04-01,NE,210,3475,8,0,0,0,0,2020-04-01T20:00:00Z,4,3693,3685,3685,31,1,0,544,38,582
2020-04-02,NE,246,3978,11,0,0,0,0,2020-04-02T20:00:00Z,5,4235,4224,4224,31,1,0,503,36,539
2020-04-03,NE,279,4487,11,0,0,0,0,2020-04-03T20:00:00Z,6,4777,4766,4766,31,1,0,509,33,542
2020-04-04,NE,321,5058,10,0,0,0,0,2020-04-04T20:00:00Z,6,5389,5379,5379,31,0,0,571,42,613
2020-04-05,NE,363,5558,12,0,0,0,0,2020-04-05T20:00:00Z,8,5933,5921,5921,31,2,0,500,42,542
2020-04-06,NE,409,6378,8,0,0,0,0,2020-04-06T20:00:00Z,8,6795,6787,6787,31,0,0,820,46,866
2020-03-04,NH,2,10,7,0,0,0,0,2020-03-04T21:00:00Z,0,19,12,12,33,0,0,0,0,0
2020-03-05,NH,2,16,4,0,0,0,0,2020-03-05T21:00:00Z,0,22,18,18,33,0,0,6,0,6
2020-03-06,NH,2,20,3,0,0,0,0,2020-03-06T21:00:00Z,0,25,22,22,33,0,0,4,0,4
2020-03-07,NH,2,20,3,0,0,0,0,2020-03-07T21:00:00Z,0,25,22,22,33,0,0,0,0,0
2020-03-08,NH,4,38,5,0,0,0,0,2020-03-08T20:00:00Z,0,47,42,42,33,0,0,18,2,20
2020-03-09,NH,4,38,5,0,0,0,0,2020-03-09T20:00:00Z,0,47,42,42,33,0,0,0,0,0
2020-03-10,NH,4,38,5,0,0,0,0,2020-03-10T20:00:00Z,0,47,42,42,33,0,0,0,0,0
2020-03-11,NH,4,38,5,0,0,0,0,2020-03-11T20:00:00Z,0,47,42,42,33,0,0,0,0,0
2020-03-12,NH,6,94,21,0,0,0,0,2020-03-12T20:00:00Z,0,121,100,100,33,0,0,56,2,58
2020-03-13,NH,6,94,21,0,0,0,0,2020-03-13T20:00:00Z,0,121,100,100,33,0,0,0,0,0
2020-03-14,NH,7,212,31,0,0,0,0,2020-03-14T20:00:00Z,0,250,219,219,33,0,0,118,1,119
2020-03-15,NH,13,271,95,0,0,0,0,2020-03-15T20:00:00Z,0,379,284,284,33,0,0,59,6,65
2020-03-16,NH,13,271,95,0,0,0,0,2020-03-16T20:00:00Z,0,379,284,284,33,0,0,0,0,0
2020-03-17,NH,17,355,195,0,0,0,0,2020-03-17T20:00:00Z,0,567,372,372,33,0,0,84,4,88
2020-03-18,NH,26,513,208,0,0,0,0,2020-03-18T20:00:00Z,0,747,539,539,33,0,0,158,9,167
2020-03-19,NH,39,621,231,0,0,0,0,2020-03-19T20:00:00Z,0,891,660,660,33,0,0,108,13,121
2020-03-20,NH,44,745,631,0,0,0,0,2020-03-20T20:00:00Z,0,1420,789,789,33,0,0,124,5,129
2020-03-21,NH,55,973,942,0,0,0,0,2020-03-21T20:00:00Z,0,1970,1028,1028,33,0,0,228,11,239
2020-03-22,NH,65,1188,959,0,0,0,0,2020-03-22T20:00:00Z,0,2212,1253,1253,33,0,0,215,10,225
2020-03-23,NH,78,1374,889,0,0,0,0,2020-03-23T20:00:00Z,0,2341,1452,1452,33,0,0,186,13,199
2020-03-24,NH,101,1447,869,0,0,0,0,2020-03-24T20:00:00Z,1,2417,1548,1548,33,1,11,73,23,96
2020-03-25,NH,108,2356,804,0,0,0,0,2020-03-25T20:00:00Z,1,3268,2464,2464,33,0,2,909,7,916
2020-03-26,NH,137,3001,712,0,0,0,0,2020-03-26T20:00:00Z,1,3850,3138,3138,33,0,6,645,29,674
2020-03-27,NH,158,3395,592,0,0,0,0,2020-03-27T20:00:00Z,1,4145,3553,3553,33,0,6,394,21,415
2020-03-28,NH,187,3656,296,0,0,0,0,2020-03-28T20:00:00Z,2,4139,3843,3843,33,1,5,261,29,290
2020-03-29,NH,214,4524,285,0,0,0,0,2020-03-29T20:00:00Z,2,5023,4738,4738,33,0,3,868,27,895
2020-03-30,NH,314,5386,144,0,0,0,0,2020-03-30T20:00:00Z,3,5844,5700,5700,33,1,12,862,100,962
2020-03-31,NH,314,5413,65,45,0,0,0,2020-03-31T20:00:00Z,3,5792,5727,5727,33,0,0,27,0,27
2020-04-01,NH,415,5985,97,0,0,0,56,2020-04-01T20:00:00Z,4,6497,6400,6400,33,1,14,572,101,673
2020-04-02,NH,415,6078,126,58,0,0,91,2020-04-02T20:00:00Z,4,6619,6493,6493,33,0,0,93,0,93
2020-04-03,NH,479,6575,114,0,0,0,101,2020-04-03T20:00:00Z,5,7168,7054,7054,33,1,14,497,64,561
2020-04-04,NH,540,6965,94,0,0,0,144,2020-04-04T20:00:00Z,7,7599,7505,7505,33,2,7,390,61,451
2020-04-05,NH,621,7411,93,0,0,0,146,2020-04-05T20:00:00Z,9,8125,8032,8032,33,2,6,446,81,527
2020-04-06,NH,669,7701,101,0,0,0,147,2020-04-06T20:00:00Z,9,8471,8370,8370,33,0,6,290,48,338
2020-03-05,NJ,1,0,0,0,0,0,0,2020-03-05T21:00:00Z,0,1,1,1,34,0,0,0,0,0
2020-03-06,NJ,1,0,0,0,0,0,0,2020-03-06T21:00:00Z,0,1,1,1,34,0,0,0,0,0
2020-03-07,NJ,4,0,1,0,0,0,0,2020-03-07T21:00:00Z,0,5,4,4,34,0,0,0,3,3
2020-03-08,NJ,6,31,0,0,0,0,0,2020-03-08T20:00:00Z,0,37,37,37,34,0,0,31,2,33
2020-03-09,NJ,11,35,14,0,0,0,0,2020-03-09T20:00:00Z,0,60,46,46,34,0,0,4,5,9
2020-03-10,NJ,15,44,20,0,0,0,0,2020-03-10T20:00:00Z,0,79,59,59,34,0,0,9,4,13
2020-03-11,NJ,24,57,20,0,0,0,0,2020-03-11T20:00:00Z,1,101,81,81,34,1,0,13,9,22
2020-03-12,NJ,30,74,20,0,0,0,0,2020-03-12T20:00:00Z,1,124,104,104,34,0,0,17,6,23
2020-03-13,NJ,50,97,80,0,0,0,0,2020-03-13T20:00:00Z,1,227,147,147,34,0,0,23,20,43
2020-03-14,NJ,50,97,80,0,0,0,0,2020-03-14T20:00:00Z,1,227,147,147,34,0,0,0,0,0
2020-03-15,NJ,98,120,34,0,0,0,0,2020-03-15T20:00:00Z,2,252,218,218,34,1,0,23,48,71
2020-03-16,NJ,178,120,20,0,0,0,0,2020-03-16T20:00:00Z,2,318,298,298,34,0,0,0,80,80
2020-03-17,NJ,267,163,55,0,0,0,0,2020-03-17T20:00:00Z,3,485,430,430,34,1,0,43,89,132
2020-03-18,NJ,427,190,21,0,0,0,0,2020-03-18T20:00:00Z,5,638,617,617,34,2,0,27,160,187
2020-03-19,NJ,742,210,74,0,0,0,0,2020-03-19T20:00:00Z,9,1026,952,952,34,4,0,20,315,335
2020-03-20,NJ,890,264,86,0,0,0,0,2020-03-20T20:00:00Z,11,1240,1154,1154,34,2,0,54,148,202
2020-03-21,NJ,1327,294,40,0,0,0,0,2020-03-21T20:00:00Z,16,1661,1621,1621,34,5,0,30,437,467
2020-03-22,NJ,1914,327,49,0,0,0,0,2020-03-22T20:00:00Z,20,2290,2241,2241,34,4,0,33,587,620
2020-03-23,NJ,2844,359,94,0,0,0,0,2020-03-23T20:00:00Z,27,3297,3203,3203,34,7,0,32,930,962
2020-03-24,NJ,3675,8325,45,0,0,0,0,2020-03-24T20:00:00Z,44,12045,12000,12000,34,17,0,7966,831,8797
2020-03-25,NJ,4402,10452,0,0,0,0,0,2020-03-25T20:00:00Z,62,14854,14854,14854,34,18,0,2127,727,2854
2020-03-26,NJ,6876,13661,0,0,0,0,0,2020-03-26T20:00:00Z,81,20537,20537,20537,34,19,0,3209,2474,5683
2020-03-27,NJ,8825,16547,0,0,0,0,0,2020-03-27T20:00:00Z,108,25372,25372,25372,34,27,0,2886,1949,4835
2020-03-28,NJ,11124,19386,0,0,0,0,0,2020-03-28T20:00:00Z,140,30510,30510,30510,34,32,0,2839,2299,5138
2020-03-29,NJ,13386,22216,0,0,0,0,0,2020-03-29T20:00:00Z,161,35602,35602,35602,34,21,0,2830,2262,5092
2020-03-30,NJ,16636,25224,0,0,0,0,0,2020-03-30T20:00:00Z,198,41860,41860,41860,34,37,0,3008,3250,6258
2020-03-31,NJ,18696,27077,0,0,0,0,0,2020-03-31T20:00:00Z,267,45773,45773,45773,34,69,0,1853,2060,3913
2020-04-01,NJ,22255,30387,0,0,0,0,0,2020-04-01T20:00:00Z,355,52642,52642,52642,34,88,0,3310,3559,6869
2020-04-02,NJ,25590,33520,0,0,0,0,0,2020-04-02T20:00:00Z,537,59110,59110,59110,34,182,0,3133,3335,6468
2020-04-03,NJ,29895,37608,0,0,0,0,0,2020-04-03T20:00:00Z,646,67503,67503,67503,34,109,0,4088,4305,8393
2020-04-04,NJ,34124,41232,0,0,0,0,0,2020-04-04T20:00:00Z,846,75356,75356,75356,34,200,0,3624,4229,7853
2020-04-05,NJ,37505,44661,0,0,0,0,0,2020-04-05T20:00:00Z,917,82166,82166,82166,34,71,0,3429,3381,6810
2020-04-06,NJ,41090,47942,0,4000,0,1263,0,2020-04-06T20:00:00Z,1003,89032,89032,89032,34,86,0,3281,3585,6866
2020-03-06,NM,0,16,0,0,0,0,0,2020-03-06T21:00:00Z,0,16,16,16,35,0,0,0,0,0
2020-03-07,NM,0,48,0,0,0,0,0,2020-03-07T21:00:00Z,0,48,48,48,35,0,0,32,0,32
2020-03-08,NM,0,48,0,0,0,0,0,2020-03-08T20:00:00Z,0,48,48,48,35,0,0,0,0,0
2020-03-09,NM,0,57,0,0,0,0,0,2020-03-09T20:00:00Z,0,57,57,57,35,0,0,9,0,9
2020-03-10,NM,0,69,0,0,0,0,0,2020-03-10T20:00:00Z,0,69,69,69,35,0,0,12,0,12
2020-03-11,NM,3,87,0,0,0,0,0,2020-03-11T20:00:00Z,0,90,90,90,35,0,0,18,3,21
2020-03-12,NM,5,155,0,0,0,0,0,2020-03-12T20:00:00Z,0,160,160,160,35,0,0,68,2,70
2020-03-13,NM,10,190,0,0,0,0,0,2020-03-13T20:00:00Z,0,200,200,200,35,0,0,35,5,40
2020-03-14,NM,10,237,0,0,0,0,0,2020-03-14T20:00:00Z,0,247,247,247,35,0,0,47,0,47
2020-03-15,NM,13,482,0,0,0,0,0,2020-03-15T20:00:00Z,0,495,495,495,35,0,0,245,3,248
2020-03-16,NM,17,566,0,0,0,0,0,2020-03-16T20:00:00Z,0,583,583,583,35,0,0,84,4,88
2020-03-17,NM,23,1249,0,0,0,0,0,2020-03-17T20:00:00Z,0,1272,1272,1272,35,0,0,683,6,689
2020-03-18,NM,28,2326,0,0,0,0,0,2020-03-18T20:00:00Z,0,2354,2354,2354,35,0,0,1077,5,1082
2020-03-19,NM,35,2762,0,0,0,0,0,2020-03-19T20:00:00Z,0,2797,2797,2797,35,0,0,436,7,443
2020-03-20,NM,43,3771,0,0,0,0,0,2020-03-20T20:00:00Z,0,3814,3814,3814,35,0,0,1009,8,1017
2020-03-21,NM,57,3771,0,0,0,0,0,2020-03-21T20:00:00Z,0,3828,3828,3828,35,0,0,0,14,14
2020-03-22,NM,57,4722,0,0,0,0,0,2020-03-22T20:00:00Z,0,4779,4779,4779,35,0,0,951,0,951
2020-03-23,NM,65,5321,0,0,0,0,0,2020-03-23T20:00:00Z,0,5386,5386,5386,35,0,0,599,8,607
2020-03-24,NM,83,5890,0,0,0,0,0,2020-03-24T20:00:00Z,0,5973,5973,5973,35,0,0,569,18,587
2020-03-25,NM,100,6742,0,0,0,0,0,2020-03-25T20:00:00Z,1,6842,6842,6842,35,1,0,852,17,869
2020-03-26,NM,112,7681,0,0,0,0,0,2020-03-26T20:00:00Z,1,7793,7793,7793,35,0,0,939,12,951
2020-03-27,NM,136,8377,0,0,0,0,0,2020-03-27T20:00:00Z,1,8513,8513,8513,35,0,0,696,24,720
2020-03-28,NM,191,9196,0,17,0,0,0,2020-03-28T20:00:00Z,1,9387,9387,9387,35,0,17,819,55,874
2020-03-29,NM,237,10769,0,19,0,0,2,2020-03-29T20:00:00Z,2,11006,11006,11006,35,1,2,1573,46,1619
2020-03-30,NM,237,10942,0,22,0,0,26,2020-03-30T20:00:00Z,2,11179,11179,11179,35,0,3,173,0,173
2020-03-31,NM,281,12246,0,22,0,0,26,2020-03-31T20:00:00Z,4,12527,12527,12527,35,2,0,1304,44,1348
2020-04-01,NM,315,12925,0,24,0,0,26,2020-04-01T20:00:00Z,5,13240,13240,13240,35,1,2,679,34,713
2020-04-02,NM,363,13648,0,31,0,0,26,2020-04-02T20:00:00Z,6,14011,14011,14011,35,1,7,723,48,771
2020-04-03,NM,403,14375,0,31,0,0,26,2020-04-03T20:00:00Z,7,14778,14778,14778,35,1,0,727,40,767
2020-04-04,NM,495,15137,0,41,0,18,26,2020-04-04T20:00:00Z,10,15632,15632,15632,35,3,0,762,92,854
2020-04-05,NM,543,16285,0,37,0,18,54,2020-04-05T20:00:00Z,11,16828,16828,16828,35,1,0,1148,48,1196
2020-04-06,NM,624,18512,0,45,0,18,130,2020-04-06T20:00:00Z,12,19136,19136,19136,35,1,0,2227,81,2308
2020-03-05,NV,1,14,0,0,0,0,0,2020-03-05T21:00:00Z,0,15,15,15,32,0,0,0,0,0
2020-03-06,NV,1,14,0,0,0,0,0,2020-03-06T21:00:00Z,0,15,15,15,32,0,0,0,0,0
2020-03-07,NV,1,14,0,0,0,0,0,2020-03-07T21:00:00Z,0,15,15,15,32,0,0,0,0,0
2020-03-08,NV,1,14,0,0,0,0,0,2020-03-08T20:00:00Z,0,15,15,15,32,0,0,0,0,0
2020-03-09,NV,1,14,0,0,0,0,0,2020-03-09T20:00:00Z,0,15,15,15,32,0,0,0,0,0
2020-03-10,NV,1,14,0,0,0,0,0,2020-03-10T20:00:00Z,0,14,15,15,32,0,0,0,0,-1
2020-03-11,NV,5,168,0,0,0,0,0,2020-03-11T20:00:00Z,0,173,173,173,32,0,0,154,5,159
2020-03-12,NV,7,168,0,0,0,0,0,2020-03-12T20:00:00Z,0,175,175,175,32,0,0,0,2,2
2020-03-13,NV,11,168,0,0,0,0,0,2020-03-13T20:00:00Z,0,179,179,179,32,0,0,0,4,4
2020-03-14,NV,20,168,0,0,0,0,0,2020-03-14T20:00:00Z,0,188,188,188,32,0,0,0,9,9
2020-03-15,NV,21,168,164,0,0,0,0,2020-03-15T20:00:00Z,0,353,189,189,32,0,0,0,1,1
2020-03-16,NV,45,168,0,0,0,0,0,2020-03-16T20:00:00Z,1,213,213,213,32,1,0,0,24,24
2020-03-17,NV,55,168,0,0,0,0,0,2020-03-17T20:00:00Z,1,223,223,223,32,0,0,0,10,10
2020-03-18,NV,55,168,0,0,0,0,0,2020-03-18T20:00:00Z,1,223,223,223,32,0,0,0,0,0
2020-03-19,NV,95,1626,0,0,0,0,0,2020-03-19T20:00:00Z,1,1721,1721,1721,32,0,0,1458,40,1498
2020-03-20,NV,109,1992,-3,0,0,0,0,2020-03-20T20:00:00Z,1,2098,2101,2101,32,0,0,366,14,380
2020-03-21,NV,124,2384,0,0,0,0,0,2020-03-21T20:00:00Z,2,2508,2508,2508,32,1,0,392,15,407
2020-03-22,NV,190,2448,0,0,0,0,0,2020-03-22T20:00:00Z,2,2638,2638,2638,32,0,0,64,66,130
2020-03-23,NV,245,3490,0,0,0,0,0,2020-03-23T20:00:00Z,4,3735,3735,3735,32,2,0,1042,55,1097
2020-03-24,NV,278,3954,0,0,0,0,0,2020-03-24T20:00:00Z,4,4232,4232,4232,32,0,0,464,33,497
2020-03-25,NV,321,4251,0,0,0,0,0,2020-03-25T20:00:00Z,6,4572,4572,4572,32,2,0,297,43,340
2020-03-26,NV,420,4697,0,0,0,0,0,2020-03-26T20:00:00Z,10,5117,5117,5117,32,4,0,446,99,545
2020-03-27,NV,535,6161,0,0,0,0,0,2020-03-27T20:00:00Z,10,6696,6696,6696,32,0,0,1464,115,1579
2020-03-28,NV,621,7901,0,0,0,0,0,2020-03-28T20:00:00Z,10,8522,8522,8522,32,0,0,1740,86,1826
2020-03-29,NV,738,8412,0,0,0,0,0,2020-03-29T20:00:00Z,14,9150,9150,9150,32,4,0,511,117,628
2020-03-30,NV,1008,10207,0,0,0,0,0,2020-03-30T20:00:00Z,15,11215,11215,11215,32,1,0,1795,270,2065
2020-03-31,NV,1113,10681,0,0,0,0,0,2020-03-31T20:00:00Z,17,11794,11794,11794,32,2,0,474,105,579
2020-04-01,NV,1279,11519,0,0,0,0,0,2020-04-01T20:00:00Z,26,12798,12798,12798,32,9,0,838,166,1004
2020-04-02,NV,1458,12588,0,0,0,0,0,2020-04-02T20:00:00Z,38,14046,14046,14046,32,12,0,1069,179,1248
2020-04-03,NV,1514,13018,0,0,0,0,0,2020-04-03T20:00:00Z,43,14532,14532,14532,32,5,0,430,56,486
2020-04-04,NV,1742,14421,0,0,0,0,0,2020-04-04T20:00:00Z,46,16163,16163,16163,32,3,0,1403,228,1631
2020-04-05,NV,1836,14995,0,0,0,0,0,2020-04-05T20:00:00Z,46,16831,16831,16831,32,0,0,574,94,668
2020-04-06,NV,1953,15676,0,0,0,0,0,2020-04-06T20:00:00Z,46,17629,17629,17629,32,0,0,681,117,798
2020-03-04,NY,6,48,24,0,0,0,0,2020-03-04T21:00:00Z,0,78,54,54,36,0,0,0,0,0
2020-03-05,NY,22,76,24,0,0,0,0,2020-03-05T21:00:00Z,0,122,98,98,36,0,0,28,16,44
2020-03-06,NY,33,92,236,0,0,0,0,2020-03-06T21:00:00Z,0,361,125,125,36,0,0,16,11,27
2020-03-07,NY,76,92,236,0,0,0,0,2020-03-07T21:00:00Z,0,404,168,168,36,0,0,0,43,43
2020-03-08,NY,105,92,0,0,0,0,0,2020-03-08T20:00:00Z,0,197,197,197,36,0,0,0,29,29
2020-03-09,NY,142,92,0,0,0,0,0,2020-03-09T20:00:00Z,0,234,234,234,36,0,0,0,37,37
2020-03-10,NY,173,92,0,0,0,0,0,2020-03-10T20:00:00Z,0,265,265,265,36,0,0,0,31,31
2020-03-11,NY,216,92,0,0,0,0,0,2020-03-11T20:00:00Z,0,308,308,308,36,0,0,0,43,43
2020-03-12,NY,216,92,0,0,0,0,0,2020-03-12T20:00:00Z,0,308,308,308,36,0,0,0,0,0
2020-03-13,NY,421,2779,0,0,0,0,0,2020-03-13T20:00:00Z,0,3200,3200,3200,36,0,0,2687,205,2892
2020-03-14,NY,524,2779,0,0,0,0,0,2020-03-14T20:00:00Z,0,3303,3303,3303,36,0,0,0,103,103
2020-03-15,NY,729,4543,0,0,0,0,0,2020-03-15T20:00:00Z,3,5272,5272,5272,36,3,0,1764,205,1969
2020-03-16,NY,950,4543,0,0,0,0,0,2020-03-16T20:00:00Z,7,5493,5493,5493,36,4,0,0,221,221
2020-03-17,NY,1700,5506,0,0,0,0,0,2020-03-17T20:00:00Z,7,7206,7206,7206,36,0,0,963,750,1713
2020-03-18,NY,2382,12215,0,0,0,0,0,2020-03-18T20:00:00Z,12,14597,14597,14597,36,5,0,6709,682,7391
2020-03-19,NY,4152,18132,0,0,0,0,0,2020-03-19T20:00:00Z,12,22284,22284,22284,36,0,0,5917,1770,7687
2020-03-20,NY,7102,25325,0,0,0,0,0,2020-03-20T20:00:00Z,35,32427,32427,32427,36,23,0,7193,2950,10143
2020-03-21,NY,10356,35081,0,0,0,0,0,2020-03-21T20:00:00Z,44,45437,45437,45437,36,9,1603,9756,3254,13010
2020-03-22,NY,15168,46233,0,0,0,0,0,2020-03-22T20:00:00Z,114,61401,61401,61401,36,70,371,11152,4812,15964
2020-03-23,NY,20875,57414,0,0,0,0,0,2020-03-23T20:00:00Z,114,78289,78289,78289,36,0,661,11181,5707,16888
2020-03-24,NY,25665,65605,0,0,0,0,0,2020-03-24T20:00:00Z,210,91270,91270,91270,36,96,599,8191,4790,12981
2020-03-25,NY,30811,72668,0,0,0,0,0,2020-03-25T20:00:00Z,285,103479,103479,103479,36,75,571,7063,5146,12209
2020-03-26,NY,37258,84846,0,5327,1290,0,0,2020-03-26T20:00:00Z,385,122104,122104,122104,36,100,3039,12178,6447,18625
2020-03-27,NY,44635,101118,0,6481,1583,0,2045,2020-03-27T20:00:00Z,519,145753,145753,145753,36,134,1682,16272,7377,23649
2020-03-28,NY,52318,103616,0,7328,1755,0,2726,2020-03-28T20:00:00Z,728,155934,155934,155934,36,209,1528,2498,7683,10181
2020-03-29,NY,59513,112847,0,8503,2037,0,3572,2020-03-29T20:00:00Z,965,172360,172360,172360,36,237,2021,9231,7195,16426
2020-03-30,NY,66497,119971,0,9517,2352,0,4204,2020-03-30T20:00:00Z,1218,186468,186468,186468,36,253,1646,7124,6984,14108
2020-03-31,NY,75795,129391,0,10929,2710,0,4975,2020-03-31T20:00:00Z,1550,205186,205186,205186,36,332,2183,9420,9298,18718
2020-04-01,NY,83712,137168,0,12226,3022,0,6142,2020-04-01T20:00:00Z,1941,220880,220880,220880,36,391,2464,7777,7917,15694
2020-04-02,NY,92381,146584,0,13383,3396,0,7434,2020-04-02T20:00:00Z,2373,238965,238965,238965,36,432,2449,9416,8669,18085
2020-04-03,NY,102863,157657,0,14810,3731,0,8886,2020-04-03T20:00:00Z,2935,260520,260520,260520,36,562,2879,11073,10482,21555
2020-04-04,NY,113704,169917,0,15905,4126,0,10478,2020-04-04T20:00:00Z,3565,283621,283621,283621,36,630,2687,12260,10841,23101
2020-04-05,NY,122031,180249,0,16479,4376,0,12187,2020-04-05T20:00:00Z,4159,302280,302280,302280,36,594,1709,10332,8327,18659
2020-04-06,NY,130689,190122,0,16837,4504,0,13366,2020-04-06T20:00:00Z,4758,320811,320811,320811,36,599,2111,9873,8658,18531
2020-03-05,OH,0,7,3,0,0,0,0,2020-03-05T21:00:00Z,0,10,7,7,39,0,0,0,0,0
2020-03-06,OH,0,8,2,0,0,0,0,2020-03-06T21:00:00Z,0,10,8,8,39,0,0,1,0,1
2020-03-07,OH,0,9,5,0,0,0,0,2020-03-07T21:00:00Z,0,14,9,9,39,0,0,1,0,1
2020-03-08,OH,0,10,4,0,0,0,0,2020-03-08T20:00:00Z,0,14,10,10,39,0,0,1,0,1
2020-03-09,OH,3,11,5,0,0,0,0,2020-03-09T20:00:00Z,0,19,14,14,39,0,0,1,3,4
2020-03-10,OH,3,14,15,0,0,0,0,2020-03-10T20:00:00Z,0,32,17,17,39,0,0,3,0,3
2020-03-11,OH,4,21,24,0,0,0,0,2020-03-11T20:00:00Z,0,49,25,25,39,0,0,7,1,8
2020-03-12,OH,5,30,52,0,0,0,0,2020-03-12T20:00:00Z,0,87,35,35,39,0,0,9,1,10
2020-03-13,OH,13,50,159,0,0,0,0,2020-03-13T20:00:00Z,0,222,63,63,39,0,0,20,8,28
2020-03-14,OH,13,50,159,0,0,0,0,2020-03-14T20:00:00Z,0,222,63,63,39,0,0,0,0,0
2020-03-15,OH,36,139,350,0,0,0,0,2020-03-15T20:00:00Z,0,525,175,175,39,0,0,89,23,112
2020-03-16,OH,50,140,361,0,0,0,0,2020-03-16T20:00:00Z,0,551,190,190,39,0,0,1,14,15
2020-03-17,OH,67,140,0,0,0,0,0,2020-03-17T20:00:00Z,0,207,207,207,39,0,0,0,17,17
2020-03-18,OH,88,140,0,0,0,0,0,2020-03-18T20:00:00Z,0,228,228,228,39,0,0,0,21,21
2020-03-19,OH,119,140,0,0,0,0,0,2020-03-19T20:00:00Z,0,259,259,259,39,0,0,0,31,31
2020-03-20,OH,169,140,0,0,0,0,0,2020-03-20T20:00:00Z,1,309,309,309,39,1,0,0,50,50
2020-03-21,OH,247,140,0,0,0,0,0,2020-03-21T20:00:00Z,3,387,387,387,39,2,58,0,78,78
2020-03-22,OH,351,140,0,0,0,0,0,2020-03-22T20:00:00Z,3,491,491,491,39,0,25,0,104,104
2020-03-23,OH,442,140,0,0,0,0,0,2020-03-23T20:00:00Z,6,582,582,582,39,3,21,0,91,91
2020-03-24,OH,564,140,0,0,0,0,0,2020-03-24T20:00:00Z,8,704,704,704,39,2,41,0,122,122
2020-03-25,OH,704,14060,0,0,0,0,0,2020-03-25T20:00:00Z,10,14764,14764,14764,39,2,37,13920,140,14060
2020-03-26,OH,867,16449,0,0,0,0,0,2020-03-26T20:00:00Z,15,17316,17316,17316,39,5,41,2389,163,2552
2020-03-27,OH,1137,19012,0,0,0,0,0,2020-03-27T20:00:00Z,19,20149,20149,20149,39,4,53,2563,270,2833
2020-03-28,OH,1406,19012,0,0,0,0,0,2020-03-28T20:00:00Z,25,20418,20418,20418,39,6,68,0,269,269
2020-03-29,OH,1653,19012,0,0,0,0,0,2020-03-29T20:00:00Z,29,20665,20665,20665,39,4,59,0,247,247
2020-03-30,OH,1933,25342,0,312,0,0,0,2020-03-30T20:00:00Z,39,27275,27275,27275,39,10,72,6330,280,6610
2020-03-31,OH,2199,26992,0,387,0,0,0,2020-03-31T20:00:00Z,55,29191,29191,29191,39,16,110,1650,266,1916
2020-04-01,OH,2547,26992,0,679,0,0,0,2020-04-01T20:00:00Z,65,29539,29539,29539,39,10,94,0,348,348
2020-04-02,OH,2902,32016,0,0,0,0,0,2020-04-02T20:00:00Z,81,34918,34918,34918,39,16,123,5024,355,5379
2020-04-03,OH,3312,35063,0,0,0,0,0,2020-04-03T20:00:00Z,91,38375,38375,38375,39,10,93,3047,410,3457
2020-04-04,OH,3739,38132,0,0,0,0,0,2020-04-04T20:00:00Z,102,41871,41871,41871,39,11,111,3069,427,3496
2020-04-05,OH,4043,39713,0,0,0,0,0,2020-04-05T20:00:00Z,119,43756,43756,43756,39,17,98,1581,304,1885
2020-04-06,OH,4450,43928,0,0,0,0,0,2020-04-06T20:00:00Z,142,48378,48378,48378,39,23,110,4215,407,4622
2020-03-07,OK,1,0,0,0,0,0,0,2020-03-07T21:00:00Z,0,1,1,1,40,0,0,0,0,0
2020-03-08,OK,1,8,2,0,0,0,0,2020-03-08T20:00:00Z,0,11,9,9,40,0,0,8,0,8
2020-03-09,OK,1,8,10,0,0,0,0,2020-03-09T20:00:00Z,0,19,9,9,40,0,0,0,0,0
2020-03-10,OK,2,15,11,0,0,0,0,2020-03-10T20:00:00Z,0,28,17,17,40,0,0,7,1,8
2020-03-11,OK,2,15,11,0,0,0,0,2020-03-11T20:00:00Z,0,28,17,17,40,0,0,0,0,0
2020-03-12,OK,3,36,4,0,0,0,0,2020-03-12T20:00:00Z,0,43,39,39,40,0,0,21,1,22
2020-03-13,OK,3,36,37,0,0,0,0,2020-03-13T20:00:00Z,0,76,39,39,40,0,0,0,0,0
2020-03-14,OK,4,36,37,0,0,0,0,2020-03-14T20:00:00Z,0,77,40,40,40,0,0,0,1,1
2020-03-15,OK,9,118,12,0,0,0,0,2020-03-15T20:00:00Z,0,139,127,127,40,0,0,82,5,87
2020-03-16,OK,10,174,29,0,0,0,0,2020-03-16T20:00:00Z,0,213,184,184,40,0,0,56,1,57
2020-03-17,OK,17,247,82,0,0,0,0,2020-03-17T20:00:00Z,0,346,264,264,40,0,0,73,7,80
2020-03-18,OK,29,378,110,0,0,0,0,2020-03-18T20:00:00Z,0,517,407,407,40,0,0,131,12,143
2020-03-19,OK,44,466,250,0,0,0,0,2020-03-19T20:00:00Z,1,760,510,510,40,1,0,88,15,103
2020-03-20,OK,49,538,374,0,0,0,0,2020-03-20T20:00:00Z,1,961,587,587,40,0,0,72,5,77
2020-03-21,OK,53,560,144,0,0,0,0,2020-03-21T20:00:00Z,1,757,613,613,40,0,10,22,4,26
2020-03-22,OK,67,669,102,0,0,0,0,2020-03-22T20:00:00Z,2,838,736,736,40,1,1,109,14,123
2020-03-23,OK,81,694,102,0,0,0,0,2020-03-23T20:00:00Z,2,877,775,775,40,0,4,25,14,39
2020-03-24,OK,106,735,0,0,0,0,0,2020-03-24T20:00:00Z,3,841,841,841,40,1,10,41,25,66
2020-03-25,OK,164,805,0,0,0,0,0,2020-03-25T20:00:00Z,5,969,969,969,40,2,34,70,58,128
2020-03-26,OK,248,958,0,0,0,0,0,2020-03-26T20:00:00Z,7,1206,1206,1206,40,2,27,153,84,237
2020-03-27,OK,322,1084,0,0,0,0,0,2020-03-27T20:00:00Z,8,1406,1406,1406,40,1,19,126,74,200
2020-03-28,OK,377,1180,0,0,0,0,0,2020-03-28T20:00:00Z,15,1557,1557,1557,40,7,21,96,55,151
2020-03-29,OK,429,1205,0,0,0,0,0,2020-03-29T20:00:00Z,16,1634,1634,1634,40,1,14,25,52,77
2020-03-30,OK,481,1207,0,0,0,0,0,2020-03-30T20:00:00Z,17,1688,1688,1688,40,1,13,2,52,54
2020-03-31,OK,565,1229,0,0,0,0,0,2020-03-31T20:00:00Z,23,1794,1794,1794,40,6,24,22,84,106
2020-04-01,OK,719,1248,0,0,0,0,0,2020-04-01T20:00:00Z,30,1967,1967,1967,40,7,42,19,154,173
2020-04-02,OK,879,1265,0,0,0,0,0,2020-04-02T20:00:00Z,34,2144,2144,2144,40,4,38,17,160,177
2020-04-03,OK,988,1315,0,0,0,0,0,2020-04-03T20:00:00Z,38,2303,2303,2303,40,4,32,50,109,159
2020-04-04,OK,1159,1362,0,0,0,0,0,2020-04-04T20:00:00Z,42,2521,2521,2521,40,4,27,47,171,218
2020-04-05,OK,1252,1401,0,0,0,0,0,2020-04-05T20:00:00Z,46,2653,2653,2653,40,4,14,39,93,132
2020-04-06,OK,1327,1422,0,0,0,0,0,2020-04-06T20:00:00Z,51,2749,2749,2749,40,5,10,21,75,96
2020-03-04,OR,3,29,18,0,0,0,0,2020-03-04T21:00:00Z,0,50,32,32,41,0,0,0,0,0
2020-03-05,OR,3,45,13,0,0,0,0,2020-03-05T21:00:00Z,0,61,48,48,41,0,0,16,0,16
2020-03-06,OR,3,64,28,0,0,0,0,2020-03-06T21:00:00Z,0,95,67,67,41,0,0,19,0,19
2020-03-07,OR,7,77,40,0,0,0,0,2020-03-07T21:00:00Z,0,124,84,84,41,0,0,13,4,17
2020-03-08,OR,14,100,53,0,0,0,0,2020-03-08T20:00:00Z,0,167,114,114,41,0,0,23,7,30
2020-03-09,OR,14,165,52,0,0,0,0,2020-03-09T20:00:00Z,0,231,179,179,41,0,0,65,0,65
2020-03-10,OR,15,213,67,0,0,0,0,2020-03-10T20:00:00Z,0,295,228,228,41,0,0,48,1,49
2020-03-11,OR,19,286,62,0,0,0,0,2020-03-11T20:00:00Z,0,367,305,305,41,0,0,73,4,77
2020-03-12,OR,19,286,62,0,0,0,0,2020-03-12T20:00:00Z,0,367,305,305,41,0,0,0,0,0
2020-03-13,OR,30,337,157,0,0,0,0,2020-03-13T20:00:00Z,0,524,367,367,41,0,0,51,11,62
2020-03-14,OR,30,337,157,0,0,0,0,2020-03-14T20:00:00Z,0,524,367,367,41,0,0,0,0,0
2020-03-15,OR,36,420,225,0,0,0,0,2020-03-15T20:00:00Z,0,681,456,456,41,0,0,83,6,89
2020-03-16,OR,39,579,182,0,0,0,0,2020-03-16T20:00:00Z,0,800,618,618,41,0,0,159,3,162
2020-03-17,OR,47,689,184,0,0,0,0,2020-03-17T20:00:00Z,0,920,736,736,41,0,0,110,8,118
2020-03-18,OR,75,1118,361,0,0,0,0,2020-03-18T20:00:00Z,3,1554,1193,1193,41,3,0,429,28,457
2020-03-19,OR,88,1329,437,0,0,0,0,2020-03-19T20:00:00Z,3,1854,1417,1417,41,0,0,211,13,224
2020-03-20,OR,114,2003,433,0,0,0,0,2020-03-20T20:00:00Z,3,2550,2117,2117,41,0,0,674,26,700
2020-03-21,OR,114,2003,433,0,0,0,0,2020-03-21T20:00:00Z,3,2550,2117,2117,41,0,0,0,0,0
2020-03-22,OR,161,2864,0,0,0,0,0,2020-03-22T20:00:00Z,4,3025,3025,3025,41,1,43,861,47,908
2020-03-23,OR,191,3649,0,0,0,0,0,2020-03-23T20:00:00Z,5,3840,3840,3840,41,1,13,785,30,815
2020-03-24,OR,209,4350,0,0,0,0,0,2020-03-24T20:00:00Z,8,4559,4559,4559,41,3,5,701,18,719
2020-03-25,OR,209,4350,0,0,0,0,0,2020-03-25T20:00:00Z,8,4559,4559,4559,41,0,0,0,0,0
2020-03-26,OR,327,6953,0,0,0,0,0,2020-03-26T20:00:00Z,11,7280,7280,7280,41,3,29,2603,118,2721
2020-03-27,OR,414,8510,0,91,0,31,0,2020-03-27T20:00:00Z,12,8924,8924,8924,41,1,12,1557,87,1644
2020-03-28,OR,479,9693,0,107,0,31,0,2020-03-28T20:00:00Z,13,10172,10172,10172,41,1,15,1183,65,1248
2020-03-29,OR,548,10878,0,107,0,37,0,2020-03-29T20:00:00Z,13,11426,11426,11426,41,0,12,1185,69,1254
2020-03-30,OR,606,12277,0,0,0,39,0,2020-03-30T20:00:00Z,16,12883,12883,12883,41,3,11,1399,58,1457
2020-03-31,OR,690,13136,0,132,0,40,0,2020-03-31T20:00:00Z,18,13826,13826,13826,41,2,14,859,84,943
2020-04-01,OR,736,13136,0,132,0,40,0,2020-04-01T20:00:00Z,18,13872,13872,13872,41,0,0,0,46,46
2020-04-02,OR,826,14132,0,134,0,38,0,2020-04-02T20:00:00Z,19,14958,14958,14958,41,1,13,996,90,1086
2020-04-03,OR,899,15259,0,188,0,38,0,2020-04-03T20:00:00Z,21,16158,16158,16158,41,2,0,1127,73,1200
2020-04-04,OR,899,16535,0,0,0,38,0,2020-04-04T20:00:00Z,22,17434,17434,17434,41,1,204,1276,0,1276
2020-04-05,OR,999,17926,0,0,0,0,0,2020-04-05T20:00:00Z,26,18925,18925,18925,41,4,35,1391,100,1491
2020-04-06,OR,1068,19556,0,0,0,0,0,2020-04-06T20:00:00Z,27,20624,20624,20624,41,1,19,1630,69,1699
2020-03-06,PA,2,0,0,0,0,0,0,2020-03-06T21:00:00Z,0,2,2,2,42,0,0,0,0,0
2020-03-07,PA,2,0,0,0,0,0,0,2020-03-07T21:00:00Z,0,2,2,2,42,0,0,0,0,0
2020-03-08,PA,4,0,0,0,0,0,0,2020-03-08T20:00:00Z,0,4,4,4,42,0,0,0,2,2
2020-03-09,PA,7,0,0,0,0,0,0,2020-03-09T20:00:00Z,0,7,7,7,42,0,0,0,3,3
2020-03-10,PA,12,0,0,0,0,0,0,2020-03-10T20:00:00Z,0,12,12,12,42,0,0,0,5,5
2020-03-11,PA,15,88,54,0,0,0,0,2020-03-11T20:00:00Z,0,157,103,103,42,0,0,88,3,91
2020-03-12,PA,22,116,81,0,0,0,0,2020-03-12T20:00:00Z,0,219,138,138,42,0,0,28,7,35
2020-03-13,PA,33,140,130,0,0,0,0,2020-03-13T20:00:00Z,0,303,173,173,42,0,0,24,11,35
2020-03-14,PA,47,205,150,0,0,0,0,2020-03-14T20:00:00Z,0,402,252,252,42,0,0,65,14,79
2020-03-15,PA,63,205,183,0,0,0,0,2020-03-15T20:00:00Z,0,451,268,268,42,0,0,0,16,16
2020-03-16,PA,76,670,0,0,0,0,0,2020-03-16T20:00:00Z,0,746,746,746,42,0,0,465,13,478
2020-03-17,PA,96,879,0,0,0,0,0,2020-03-17T20:00:00Z,0,975,975,975,42,0,0,209,20,229
2020-03-18,PA,133,1187,0,0,0,0,0,2020-03-18T20:00:00Z,0,1320,1320,1320,42,0,0,308,37,345
2020-03-19,PA,185,1608,0,0,0,0,0,2020-03-19T20:00:00Z,1,1793,1793,1793,42,1,0,421,52,473
2020-03-20,PA,268,2574,0,0,0,0,0,2020-03-20T20:00:00Z,1,2842,2842,2842,42,0,0,966,83,1049
2020-03-21,PA,371,3766,0,0,0,0,0,2020-03-21T20:00:00Z,2,4137,4137,4137,42,1,0,1192,103,1295
2020-03-22,PA,479,4964,0,0,0,0,0,2020-03-22T20:00:00Z,2,5443,5443,5443,42,0,0,1198,108,1306
2020-03-23,PA,644,6595,0,0,0,0,0,2020-03-23T20:00:00Z,6,7239,7239,7239,42,4,0,1631,165,1796
2020-03-24,PA,851,8643,0,0,0,0,0,2020-03-24T20:00:00Z,7,9494,9494,9494,42,1,0,2048,207,2255
2020-03-25,PA,1127,11193,0,0,0,0,0,2020-03-25T20:00:00Z,11,12320,12320,12320,42,4,0,2550,276,2826
2020-03-26,PA,1687,16441,0,0,0,0,0,2020-03-26T20:00:00Z,16,18128,18128,18128,42,5,0,5248,560,5808
2020-03-27,PA,2218,21016,0,0,0,0,0,2020-03-27T20:00:00Z,22,23234,23234,23234,42,6,241,4575,531,5106
2020-03-28,PA,2751,25254,0,0,0,0,0,2020-03-28T20:00:00Z,34,28005,28005,28005,42,12,75,4238,533,4771
2020-03-29,PA,3394,30061,0,0,0,0,0,2020-03-29T20:00:00Z,38,33455,33455,33455,42,4,37,4807,643,5450
2020-03-30,PA,4087,33777,0,0,0,0,0,2020-03-30T20:00:00Z,49,37864,37864,37864,42,11,33,3716,693,4409
2020-03-31,PA,4843,37645,0,0,0,0,0,2020-03-31T20:00:00Z,63,42488,42488,42488,42,14,128,3868,756,4624
2020-04-01,PA,5805,42427,0,0,0,0,0,2020-04-01T20:00:00Z,74,48232,48232,48232,42,11,106,4782,962,5744
2020-04-02,PA,7016,47698,0,0,0,0,0,2020-04-02T20:00:00Z,90,54714,54714,54714,42,16,110,5271,1211,6482
2020-04-03,PA,8420,53695,0,0,0,0,0,2020-04-03T20:00:00Z,102,62115,62115,62115,42,12,122,5997,1404,7401
2020-04-04,PA,10017,60013,0,0,0,0,0,2020-04-04T20:00:00Z,136,70030,70030,70030,42,34,152,6318,1597,7915
2020-04-05,PA,11510,66261,0,0,0,0,0,2020-04-05T20:00:00Z,150,77771,77771,77771,42,14,68,6248,1493,7741
2020-04-06,PA,12980,70874,0,0,0,533,0,2020-04-06T20:00:00Z,162,83854,83854,83854,42,12,541,4613,1470,6083
2020-03-16,PR,5,9,0,0,0,0,0,2020-03-16T20:00:00Z,0,14,14,14,72,0,0,0,0,0
2020-03-17,PR,5,13,4,0,0,0,0,2020-03-17T20:00:00Z,0,22,18,18,72,0,0,4,0,4
2020-03-18,PR,5,31,21,0,0,0,0,2020-03-18T20:00:00Z,0,57,36,36,72,0,0,18,0,18
2020-03-19,PR,5,56,29,0,0,0,0,2020-03-19T20:00:00Z,0,90,61,61,72,0,0,25,0,25
2020-03-20,PR,14,114,52,0,0,0,0,2020-03-20T20:00:00Z,0,180,128,128,72,0,0,58,9,67
2020-03-21,PR,21,143,71,0,0,0,0,2020-03-21T20:00:00Z,0,235,164,164,72,0,0,29,7,36
2020-03-22,PR,23,183,69,0,0,0,0,2020-03-22T20:00:00Z,0,275,206,206,72,0,0,40,2,42
2020-03-23,PR,31,189,35,0,0,0,0,2020-03-23T20:00:00Z,2,255,220,220,72,2,0,6,8,14
2020-03-24,PR,39,268,42,0,0,0,0,2020-03-24T20:00:00Z,2,349,307,307,72,0,0,79,8,87
2020-03-25,PR,51,317,70,0,0,0,0,2020-03-25T20:00:00Z,2,438,368,368,72,0,0,49,12,61
2020-03-26,PR,64,377,335,0,0,0,0,2020-03-26T20:00:00Z,2,776,441,441,72,0,0,60,13,73
2020-03-27,PR,79,519,334,0,0,0,0,2020-03-27T20:00:00Z,3,932,598,598,72,1,0,142,15,157
2020-03-28,PR,100,739,792,0,0,0,0,2020-03-28T20:00:00Z,3,1631,839,839,72,0,0,220,21,241
2020-03-29,PR,127,841,817,0,0,0,0,2020-03-29T20:00:00Z,5,1785,968,968,72,2,0,102,27,129
2020-03-30,PR,174,931,794,0,0,0,0,2020-03-30T20:00:00Z,6,1899,1105,1105,72,1,0,90,47,137
2020-03-31,PR,239,1195,854,0,0,0,0,2020-03-31T20:00:00Z,8,2288,1434,1434,72,2,0,264,65,329
2020-04-01,PR,286,1409,897,0,0,0,0,2020-04-01T20:00:00Z,11,2592,1695,1695,72,3,0,214,47,261
2020-04-02,PR,316,1604,1119,0,0,0,0,2020-04-02T20:00:00Z,12,3039,1920,1920,72,1,0,195,30,225
2020-04-03,PR,378,2049,1055,0,0,0,0,2020-04-03T20:00:00Z,15,3482,2427,2427,72,3,0,445,62,507
2020-04-04,PR,452,2065,1129,0,0,0,0,2020-04-04T20:00:00Z,18,3646,2517,2517,72,3,0,16,74,90
2020-04-05,PR,475,3073,1039,0,0,0,0,2020-04-05T20:00:00Z,20,4587,3548,3548,72,2,0,1008,23,1031
2020-04-06,PR,513,3432,1000,0,0,0,0,2020-04-06T20:00:00Z,21,4945,3945,3945,72,1,0,359,38,397
2020-03-07,RI,2,0,0,0,0,0,0,2020-03-07T21:00:00Z,0,2,2,2,44,0,0,0,0,0
2020-03-08,RI,3,30,12,0,0,0,0,2020-03-08T20:00:00Z,0,45,33,33,44,0,0,30,1,31
2020-03-09,RI,3,53,6,0,0,0,0,2020-03-09T20:00:00Z,0,62,56,56,44,0,0,23,0,23
2020-03-10,RI,3,53,6,0,0,0,0,2020-03-10T20:00:00Z,0,62,56,56,44,0,0,0,0,0
2020-03-11,RI,5,58,24,0,0,0,0,2020-03-11T20:00:00Z,0,87,63,63,44,0,0,5,2,7
2020-03-12,RI,5,94,8,0,0,0,0,2020-03-12T20:00:00Z,0,107,99,99,44,0,0,36,0,36
2020-03-13,RI,14,142,29,0,0,0,0,2020-03-13T20:00:00Z,0,185,156,156,44,0,0,48,9,57
2020-03-14,RI,20,198,57,0,0,0,0,2020-03-14T20:00:00Z,0,275,218,218,44,0,0,56,6,62
2020-03-15,RI,20,198,57,0,0,0,0,2020-03-15T20:00:00Z,0,275,218,218,44,0,0,0,0,0
2020-03-16,RI,21,308,149,0,0,0,0,2020-03-16T20:00:00Z,0,478,329,329,44,0,0,110,1,111
2020-03-17,RI,21,308,149,0,0,0,0,2020-03-17T20:00:00Z,0,478,329,329,44,0,0,0,0,0
2020-03-18,RI,33,540,334,0,0,0,0,2020-03-18T20:00:00Z,0,907,573,573,44,0,0,232,12,244
2020-03-19,RI,33,540,334,0,0,0,0,2020-03-19T20:00:00Z,0,907,573,573,44,0,0,0,0,0
2020-03-20,RI,54,654,140,0,0,0,0,2020-03-20T20:00:00Z,0,848,708,708,44,0,0,114,21,135
2020-03-21,RI,66,862,290,0,0,0,0,2020-03-21T20:00:00Z,0,1218,928,928,44,0,0,208,12,220
2020-03-22,RI,83,932,216,0,0,0,0,2020-03-22T20:00:00Z,0,1231,1015,1015,44,0,0,70,17,87
2020-03-23,RI,106,932,216,0,0,0,0,2020-03-23T20:00:00Z,0,1254,1038,1038,44,0,0,0,23,23
2020-03-24,RI,106,1120,77,0,0,0,0,2020-03-24T20:00:00Z,0,1303,1226,1226,44,0,0,188,0,188
2020-03-25,RI,124,1143,196,16,0,0,0,2020-03-25T20:00:00Z,0,1463,1267,1267,44,0,16,23,18,41
2020-03-26,RI,165,1339,181,23,9,6,0,2020-03-26T20:00:00Z,0,1685,1504,1504,44,0,7,196,41,237
2020-03-27,RI,165,1366,138,23,9,6,0,2020-03-27T20:00:00Z,0,1669,1531,1531,44,0,0,27,0,27
2020-03-28,RI,203,2306,138,28,9,6,0,2020-03-28T20:00:00Z,0,2647,2509,2509,44,0,5,940,38,978
2020-03-29,RI,294,2541,0,35,9,6,0,2020-03-29T20:00:00Z,3,2835,2835,2835,44,3,7,235,91,326
2020-03-30,RI,408,3187,0,41,9,6,0,2020-03-30T20:00:00Z,4,3595,3595,3595,44,1,6,646,114,760
2020-03-31,RI,488,3476,0,59,9,6,35,2020-03-31T20:00:00Z,8,3964,3964,3964,44,4,18,289,80,369
2020-04-01,RI,566,3831,0,60,14,6,35,2020-04-01T20:00:00Z,10,4397,4397,4397,44,2,1,355,78,433
2020-04-02,RI,657,4412,0,72,14,6,35,2020-04-02T20:00:00Z,12,5069,5069,5069,44,2,0,581,91,672
2020-04-03,RI,711,4412,0,72,14,6,35,2020-04-03T20:00:00Z,14,5123,5123,5123,44,2,72,0,54,54
2020-04-04,RI,806,5584,0,93,31,6,35,2020-04-04T20:00:00Z,17,6390,6390,6390,44,3,21,1172,95,1267
2020-04-05,RI,922,7181,0,103,33,6,35,2020-04-05T20:00:00Z,25,8103,8103,8103,44,8,0,1597,116,1713
2020-04-06,RI,1082,7399,0,109,37,26,35,2020-04-06T20:00:00Z,27,8481,8481,8481,44,2,0,218,160,378
2020-03-04,SC,0,5,0,0,0,0,0,2020-03-04T21:00:00Z,0,5,5,5,45,0,0,0,0,0
2020-03-05,SC,0,5,0,0,0,0,0,2020-03-05T21:00:00Z,0,5,5,5,45,0,0,0,0,0
2020-03-06,SC,0,5,0,0,0,0,0,2020-03-06T21:00:00Z,0,5,5,5,45,0,0,0,0,0
2020-03-07,SC,2,8,0,0,0,0,0,2020-03-07T21:00:00Z,0,10,10,10,45,0,0,3,2,5
2020-03-08,SC,2,8,0,0,0,0,0,2020-03-08T20:00:00Z,0,10,10,10,45,0,0,0,0,0
2020-03-09,SC,7,24,0,0,0,0,0,2020-03-09T20:00:00Z,0,31,31,31,45,0,0,16,5,21
2020-03-10,SC,7,24,0,0,0,0,0,2020-03-10T20:00:00Z,0,31,31,31,45,0,0,0,0,0
2020-03-11,SC,9,32,0,0,0,0,0,2020-03-11T20:00:00Z,0,41,41,41,45,0,0,8,2,10
2020-03-12,SC,10,48,0,0,0,0,0,2020-03-12T20:00:00Z,0,58,58,58,45,0,0,16,1,17
2020-03-13,SC,12,75,0,0,0,0,0,2020-03-13T20:00:00Z,0,87,87,87,45,0,0,27,2,29
2020-03-14,SC,13,110,0,0,0,0,0,2020-03-14T20:00:00Z,0,123,123,123,45,0,0,35,1,36
2020-03-15,SC,19,154,0,0,0,0,0,2020-03-15T20:00:00Z,0,173,173,173,45,0,0,44,6,50
2020-03-16,SC,28,235,0,0,0,0,0,2020-03-16T20:00:00Z,1,263,263,263,45,1,0,81,9,90
2020-03-17,SC,33,311,0,0,0,0,0,2020-03-17T20:00:00Z,1,344,344,344,45,0,0,76,5,81
2020-03-18,SC,60,583,0,0,0,0,0,2020-03-18T20:00:00Z,1,643,643,643,45,0,0,272,27,299
2020-03-19,SC,60,583,0,0,0,0,0,2020-03-19T20:00:00Z,1,643,643,643,45,0,0,0,0,0
2020-03-20,SC,81,833,0,0,0,0,0,2020-03-20T20:00:00Z,1,914,914,914,45,0,0,250,21,271
2020-03-21,SC,152,1255,0,0,0,0,0,2020-03-21T20:00:00Z,1,1407,1407,1407,45,0,0,422,71,493
2020-03-22,SC,195,1466,0,0,0,0,0,2020-03-22T20:00:00Z,3,1661,1661,1661,45,2,0,211,43,254
2020-03-23,SC,299,1466,0,0,0,0,0,2020-03-23T20:00:00Z,5,1765,1765,1765,45,2,0,0,104,104
2020-03-24,SC,299,2012,0,0,0,0,0,2020-03-24T20:00:00Z,5,2310,2310,2310,45,0,0,546,-1,545
2020-03-25,SC,424,2303,0,0,0,0,0,2020-03-25T20:00:00Z,7,2727,2727,2727,45,2,102,291,126,417
2020-03-26,SC,456,2307,0,0,0,0,0,2020-03-26T20:00:00Z,9,2763,2763,2763,45,2,7,4,32,36
2020-03-27,SC,456,2307,0,0,0,0,0,2020-03-27T20:00:00Z,9,2763,2763,2763,45,0,0,0,0,0
2020-03-28,SC,539,2408,0,0,0,0,0,2020-03-28T20:00:00Z,13,2947,2947,2947,45,4,20,101,83,184
2020-03-29,SC,774,3015,0,0,0,0,0,2020-03-29T20:00:00Z,16,3789,3789,3789,45,3,0,607,235,842
2020-03-30,SC,925,4160,0,0,0,0,0,2020-03-30T20:00:00Z,18,5085,5085,5085,45,2,0,1145,151,1296
2020-03-31,SC,1083,4616,0,0,0,0,0,2020-03-31T20:00:00Z,22,5699,5699,5699,45,4,130,456,158,614
2020-04-01,SC,1293,5033,0,0,0,0,0,2020-04-01T20:00:00Z,26,6326,6326,6326,45,4,90,417,210,627
2020-04-02,SC,1554,5441,0,0,0,0,0,2020-04-02T20:00:00Z,31,6995,6995,6995,45,5,547,408,261,669
2020-04-03,SC,1554,5441,0,0,0,0,0,2020-04-03T20:00:00Z,31,6995,6995,6995,45,0,-655,0,0,0
2020-04-04,SC,1917,16397,0,0,0,0,0,2020-04-04T20:00:00Z,40,18314,18314,18314,45,9,0,10956,363,11319
2020-04-05,SC,2049,16927,0,0,0,0,0,2020-04-05T20:00:00Z,44,18976,18976,18976,45,4,0,530,132,662
2020-04-06,SC,2049,16927,0,0,0,0,0,2020-04-06T20:00:00Z,44,18976,18976,18976,45,0,0,0,0,0
2020-03-07,SD,0,5,0,0,0,0,0,2020-03-07T21:00:00Z,0,5,5,5,46,0,0,0,0,0
2020-03-08,SD,0,5,0,0,0,0,0,2020-03-08T20:00:00Z,0,5,5,5,46,0,0,0,0,0
2020-03-09,SD,0,5,0,0,0,0,0,2020-03-09T20:00:00Z,0,5,5,5,46,0,0,0,0,0
2020-03-10,SD,0,11,0,0,0,0,0,2020-03-10T20:00:00Z,0,11,11,11,46,0,0,6,0,6
2020-03-11,SD,5,13,2,0,0,0,0,2020-03-11T20:00:00Z,0,20,18,18,46,0,0,2,5,7
2020-03-12,SD,8,27,11,0,0,0,0,2020-03-12T20:00:00Z,0,46,35,35,46,0,0,14,3,17
2020-03-13,SD,9,73,11,0,0,0,0,2020-03-13T20:00:00Z,0,93,82,82,46,0,0,46,1,47
2020-03-14,SD,9,182,3,0,0,0,0,2020-03-14T20:00:00Z,0,194,191,191,46,0,0,109,0,109
2020-03-15,SD,9,327,6,0,0,0,0,2020-03-15T20:00:00Z,0,342,336,336,46,0,0,145,0,145
2020-03-16,SD,10,494,0,0,0,0,0,2020-03-16T20:00:00Z,0,504,504,504,46,0,0,167,1,168
2020-03-17,SD,11,551,35,0,0,0,0,2020-03-17T20:00:00Z,0,597,562,562,46,0,0,57,1,58
2020-03-18,SD,11,551,350,0,0,0,0,2020-03-18T20:00:00Z,1,912,562,562,46,1,0,0,0,0
2020-03-19,SD,11,551,385,0,0,0,0,2020-03-19T20:00:00Z,1,947,562,562,46,0,0,0,0,0
2020-03-20,SD,14,663,270,0,0,0,0,2020-03-20T20:00:00Z,1,947,677,677,46,0,0,112,3,115
2020-03-21,SD,14,691,268,0,0,0,0,2020-03-21T20:00:00Z,1,973,705,705,46,0,0,28,0,28
2020-03-22,SD,21,740,277,0,0,0,0,2020-03-22T20:00:00Z,1,1038,761,761,46,0,0,49,7,56
2020-03-23,SD,28,762,265,0,0,0,0,2020-03-23T20:00:00Z,1,1055,790,790,46,0,0,22,7,29
2020-03-24,SD,30,790,268,0,0,0,0,2020-03-24T20:00:00Z,1,1088,820,820,46,0,0,28,2,30
2020-03-25,SD,41,819,268,0,0,0,0,2020-03-25T20:00:00Z,1,1128,860,860,46,0,0,29,11,40
2020-03-26,SD,46,1973,125,0,0,0,16,2020-03-26T20:00:00Z,1,2144,2019,2019,46,0,0,1154,5,1159
2020-03-27,SD,58,2387,20,0,0,0,21,2020-03-27T20:00:00Z,1,2465,2445,2445,46,0,0,414,12,426
2020-03-28,SD,68,2592,0,0,0,0,26,2020-03-28T20:00:00Z,1,2660,2660,2660,46,0,0,205,10,215
2020-03-29,SD,90,3127,1,0,0,0,29,2020-03-29T20:00:00Z,1,3218,3217,3217,46,0,0,535,22,557
2020-03-30,SD,101,3478,0,0,0,0,34,2020-03-30T20:00:00Z,1,3579,3579,3579,46,0,0,351,11,362
2020-03-31,SD,108,3609,0,0,0,0,44,2020-03-31T20:00:00Z,1,3717,3717,3717,46,0,12,131,7,138
2020-04-01,SD,129,3903,0,0,0,0,51,2020-04-01T20:00:00Z,2,4032,4032,4032,46,1,0,294,21,315
2020-04-02,SD,165,4217,0,0,0,0,57,2020-04-02T20:00:00Z,2,4382,4382,4382,46,0,5,314,36,350
2020-04-03,SD,187,4593,3,0,0,0,69,2020-04-03T20:00:00Z,2,4783,4780,4780,46,0,0,376,22,398
2020-04-04,SD,212,5012,1,0,0,0,76,2020-04-04T20:00:00Z,2,5225,5224,5224,46,0,2,419,25,444
2020-04-05,SD,240,5353,0,0,0,0,84,2020-04-05T20:00:00Z,2,5593,5593,5593,46,0,3,341,28,369
2020-04-06,SD,288,5732,0,0,0,0,91,2020-04-06T20:00:00Z,4,6020,6020,6020,46,2,1,379,48,427
2020-03-05,TN,1,0,0,0,0,0,0,2020-03-05T21:00:00Z,0,1,1,1,47,0,0,0,0,0
2020-03-06,TN,1,0,0,0,0,0,0,2020-03-06T21:00:00Z,0,1,1,1,47,0,0,0,0,0
2020-03-07,TN,1,0,0,0,0,0,0,2020-03-07T21:00:00Z,0,1,1,1,47,0,0,0,0,0
2020-03-08,TN,3,0,0,0,0,0,0,2020-03-08T20:00:00Z,0,3,3,3,47,0,0,0,2,2
2020-03-09,TN,3,0,0,0,0,0,0,2020-03-09T20:00:00Z,0,3,3,3,47,0,0,0,0,0
2020-03-10,TN,7,0,0,0,0,0,0,2020-03-10T20:00:00Z,0,7,7,7,47,0,0,0,4,4
2020-03-11,TN,7,50,0,0,0,0,0,2020-03-11T20:00:00Z,0,57,57,57,47,0,0,50,0,50
2020-03-12,TN,18,79,0,0,0,0,0,2020-03-12T20:00:00Z,0,97,97,97,47,0,0,29,11,40
2020-03-13,TN,26,116,0,0,0,0,0,2020-03-13T20:00:00Z,0,142,142,142,47,0,0,37,8,45
2020-03-14,TN,32,130,0,0,0,0,0,2020-03-14T20:00:00Z,0,162,162,162,47,0,0,14,6,20
2020-03-15,TN,39,157,0,0,0,0,0,2020-03-15T20:00:00Z,0,196,196,196,47,0,0,27,7,34
2020-03-16,TN,52,270,0,0,0,0,0,2020-03-16T20:00:00Z,0,322,322,322,47,0,0,113,13,126
2020-03-17,TN,73,330,0,0,0,0,0,2020-03-17T20:00:00Z,0,403,403,403,47,0,0,60,21,81
2020-03-18,TN,98,349,0,0,0,0,0,2020-03-18T20:00:00Z,0,447,447,447,47,0,0,19,25,44
2020-03-19,TN,154,349,0,0,0,0,0,2020-03-19T20:00:00Z,0,503,503,503,47,0,0,0,56,56
2020-03-20,TN,228,563,0,0,0,0,0,2020-03-20T20:00:00Z,0,791,791,791,47,0,0,214,74,288
2020-03-21,TN,371,3272,0,0,0,0,0,2020-03-21T20:00:00Z,0,3643,3643,3643,47,0,0,2709,143,2852
2020-03-22,TN,505,3272,0,0,0,0,0,2020-03-22T20:00:00Z,0,3777,3777,3777,47,0,0,0,134,134
2020-03-23,TN,615,3272,0,0,0,0,0,2020-03-23T20:00:00Z,2,3887,3887,3887,47,2,0,0,110,110
2020-03-24,TN,667,10517,0,0,0,0,0,2020-03-24T20:00:00Z,2,11184,11184,11184,47,0,0,7245,52,7297
2020-03-25,TN,784,11012,0,0,0,0,0,2020-03-25T20:00:00Z,3,11796,11796,11796,47,1,53,495,117,612
2020-03-26,TN,957,13952,0,0,0,0,0,2020-03-26T20:00:00Z,3,14909,14909,14909,47,0,23,2940,173,3113
2020-03-27,TN,1203,14888,0,0,0,0,0,2020-03-27T20:00:00Z,6,16091,16091,16091,47,3,27,936,246,1182
2020-03-28,TN,1373,16965,0,0,0,0,0,2020-03-28T20:00:00Z,6,18338,18338,18338,47,0,15,2077,170,2247
2020-03-29,TN,1537,19037,0,0,0,0,0,2020-03-29T20:00:00Z,7,20574,20574,20574,47,1,15,2072,164,2236
2020-03-30,TN,1834,21470,0,0,0,0,0,2020-03-30T20:00:00Z,13,23304,23304,23304,47,6,15,2433,297,2730
2020-03-31,TN,2239,25121,0,0,0,0,121,2020-03-31T20:00:00Z,23,27360,27360,27360,47,10,27,3651,405,4056
2020-04-01,TN,2683,29769,0,0,0,0,137,2020-04-01T20:00:00Z,24,32452,32452,32452,47,1,25,4648,444,5092
2020-04-02,TN,2845,31766,0,0,0,0,220,2020-04-02T20:00:00Z,32,34611,34611,34611,47,8,63,1997,162,2159
2020-04-03,TN,3067,34772,0,0,0,0,248,2020-04-03T20:00:00Z,37,37839,37839,37839,47,5,30,3006,222,3228
2020-04-04,TN,3321,38070,0,0,0,0,416,2020-04-04T20:00:00Z,43,41391,41391,41391,47,6,18,3298,254,3552
2020-04-05,TN,3633,41667,0,0,0,0,416,2020-04-05T20:00:00Z,44,45300,45300,45300,47,1,17,3597,312,3909
2020-04-06,TN,3802,43548,0,0,0,0,356,2020-04-06T20:00:00Z,65,47350,47350,47350,47,21,24,1881,169,2050
2020-03-04,TX,1,0,0,0,0,0,0,2020-03-04T21:00:00Z,0,1,1,1,48,0,0,0,0,0
2020-03-05,TX,1,0,0,0,0,0,0,2020-03-05T21:00:00Z,0,1,1,1,48,0,0,0,0,0
2020-03-06,TX,5,0,0,0,0,0,0,2020-03-06T21:00:00Z,0,5,5,5,48,0,0,0,4,4
2020-03-07,TX,8,0,0,0,0,0,0,2020-03-07T21:00:00Z,0,8,8,8,48,0,0,0,3,3
2020-03-08,TX,8,0,0,0,0,0,0,2020-03-08T20:00:00Z,0,8,8,8,48,0,0,0,0,0
2020-03-09,TX,12,0,0,0,0,0,0,2020-03-09T20:00:00Z,0,12,12,12,48,0,0,0,4,4
2020-03-10,TX,13,0,0,0,0,0,0,2020-03-10T20:00:00Z,0,13,13,13,48,0,0,0,1,1
2020-03-11,TX,21,0,0,0,0,0,0,2020-03-11T20:00:00Z,0,21,21,21,48,0,0,0,8,8
2020-03-12,TX,23,0,0,0,0,0,0,2020-03-12T20:00:00Z,0,23,23,23,48,0,0,0,2,2
2020-03-13,TX,39,0,0,0,0,0,0,2020-03-13T20:00:00Z,0,39,39,39,48,0,0,0,16,16
2020-03-14,TX,51,0,0,0,0,0,0,2020-03-14T20:00:00Z,0,51,51,51,48,0,0,0,12,12
2020-03-15,TX,56,0,0,0,0,0,0,2020-03-15T20:00:00Z,0,56,56,56,48,0,0,0,5,5
2020-03-16,TX,57,0,0,0,0,0,0,2020-03-16T20:00:00Z,0,57,57,57,48,0,0,0,1,1
2020-03-17,TX,64,1204,0,0,0,0,0,2020-03-17T20:00:00Z,1,1268,1268,1268,48,1,0,1204,7,1211
2020-03-18,TX,83,1824,0,0,0,0,0,2020-03-18T20:00:00Z,2,1907,1907,1907,48,1,0,620,19,639
2020-03-19,TX,143,2212,0,0,0,0,0,2020-03-19T20:00:00Z,3,2355,2355,2355,48,1,0,388,60,448
2020-03-20,TX,194,5083,0,0,0,0,0,2020-03-20T20:00:00Z,5,5277,5277,5277,48,2,0,2871,51,2922
2020-03-21,TX,304,6218,0,0,0,0,0,2020-03-21T20:00:00Z,5,6522,6522,6522,48,0,0,1135,110,1245
2020-03-22,TX,334,8422,0,0,0,0,0,2020-03-22T20:00:00Z,5,8756,8756,8756,48,0,0,2204,30,2234
2020-03-23,TX,352,9703,0,0,0,0,0,2020-03-23T20:00:00Z,8,10055,10055,10055,48,3,0,1281,18,1299
2020-03-24,TX,410,10757,0,0,0,0,0,2020-03-24T20:00:00Z,9,11167,11167,11167,48,1,0,1054,58,1112
2020-03-25,TX,974,12520,0,0,0,0,0,2020-03-25T20:00:00Z,12,13494,13494,13494,48,3,0,1763,564,2327
2020-03-26,TX,1396,20028,0,0,0,0,0,2020-03-26T20:00:00Z,18,21424,21424,21424,48,6,0,7508,422,7930
2020-03-27,TX,1731,21935,0,0,0,0,0,2020-03-27T20:00:00Z,23,23666,23666,23666,48,5,0,1907,335,2242
2020-03-28,TX,2052,23208,0,0,0,0,0,2020-03-28T20:00:00Z,27,25260,25260,25260,48,4,0,1273,321,1594
2020-03-29,TX,2552,23208,0,0,0,0,0,2020-03-29T20:00:00Z,34,25760,25760,25760,48,7,0,0,500,500
2020-03-30,TX,2877,33003,0,0,0,0,38,2020-03-30T20:00:00Z,34,35880,35880,35880,48,0,0,9795,325,10120
2020-03-31,TX,3266,39726,0,0,0,0,38,2020-03-31T20:00:00Z,41,42992,42992,42992,48,7,196,6723,389,7112
2020-04-01,TX,3997,43860,0,0,0,0,38,2020-04-01T20:00:00Z,58,47857,47857,47857,48,17,0,4134,731,4865
2020-04-02,TX,4669,46010,0,0,0,0,38,2020-04-02T20:00:00Z,70,50679,50679,50679,48,12,0,2150,672,2822
2020-04-03,TX,5330,50434,0,0,0,0,38,2020-04-03T20:00:00Z,90,55764,55764,55764,48,20,0,4424,661,5085
2020-04-04,TX,6110,57641,0,0,0,0,38,2020-04-04T20:00:00Z,105,63751,63751,63751,48,15,0,7207,780,7987
2020-04-05,TX,6812,64126,0,0,0,0,38,2020-04-05T20:00:00Z,127,70938,70938,70938,48,22,631,6485,702,7187
2020-04-06,TX,7276,78081,0,0,0,0,38,2020-04-06T20:00:00Z,140,85357,85357,85357,48,13,326,13955,464,14419
2020-03-07,UT,1,0,0,0,0,0,0,2020-03-07T21:00:00Z,0,1,1,1,49,0,0,0,0,0
2020-03-08,UT,1,0,0,0,0,0,0,2020-03-08T20:00:00Z,0,1,1,1,49,0,0,0,0,0
2020-03-09,UT,1,0,0,0,0,0,0,2020-03-09T20:00:00Z,0,1,1,1,49,0,0,0,0,0
2020-03-10,UT,2,0,0,0,0,0,0,2020-03-10T20:00:00Z,0,2,2,2,49,0,0,0,1,1
2020-03-11,UT,2,0,0,0,0,0,0,2020-03-11T20:00:00Z,0,2,2,2,49,0,0,0,0,0
2020-03-12,UT,4,131,0,0,0,0,0,2020-03-12T20:00:00Z,0,135,135,135,49,0,0,131,2,133
2020-03-13,UT,6,131,0,0,0,0,0,2020-03-13T20:00:00Z,0,137,137,137,49,0,0,0,2,2
2020-03-14,UT,6,131,0,0,0,0,0,2020-03-14T20:00:00Z,0,137,137,137,49,0,0,0,0,0
2020-03-15,UT,28,131,0,0,0,0,0,2020-03-15T20:00:00Z,0,159,159,159,49,0,0,0,22,22
2020-03-16,UT,39,131,0,0,0,0,0,2020-03-16T20:00:00Z,0,170,170,170,49,0,0,0,11,11
2020-03-17,UT,51,131,0,0,0,0,0,2020-03-17T20:00:00Z,0,182,182,182,49,0,0,0,12,12
2020-03-18,UT,63,131,0,0,0,0,0,2020-03-18T20:00:00Z,0,194,194,194,49,0,0,0,12,12
2020-03-19,UT,78,1448,0,0,0,0,0,2020-03-19T20:00:00Z,0,1526,1526,1526,49,0,0,1317,15,1332
2020-03-20,UT,112,2035,0,0,0,0,0,2020-03-20T20:00:00Z,0,2147,2147,2147,49,0,0,587,34,621
2020-03-21,UT,136,2424,0,0,0,0,0,2020-03-21T20:00:00Z,0,2560,2560,2560,49,0,0,389,24,413
2020-03-22,UT,181,3508,0,0,0,0,0,2020-03-22T20:00:00Z,1,3689,3689,3689,49,1,0,1084,45,1129
2020-03-23,UT,257,4790,0,0,0,0,0,2020-03-23T20:00:00Z,1,5047,5047,5047,49,0,0,1282,76,1358
2020-03-24,UT,299,5524,0,0,0,0,0,2020-03-24T20:00:00Z,1,5823,5823,5823,49,0,0,734,42,776
2020-03-25,UT,346,6491,0,0,0,0,0,2020-03-25T20:00:00Z,1,6837,6837,6837,49,0,0,967,47,1014
2020-03-26,UT,402,7308,0,0,0,0,0,2020-03-26T20:00:00Z,1,7710,7710,7710,49,0,0,817,56,873
2020-03-27,UT,480,8764,0,0,0,0,0,2020-03-27T20:00:00Z,2,9244,9244,9244,49,1,0,1456,78,1534
2020-03-28,UT,602,10710,0,0,0,0,0,2020-03-28T20:00:00Z,2,11312,11312,11312,49,0,0,1946,122,2068
2020-03-29,UT,719,13274,0,0,0,0,0,2020-03-29T20:00:00Z,2,13993,13993,13993,49,0,0,2564,117,2681
2020-03-30,UT,806,15197,0,0,0,0,0,2020-03-30T20:00:00Z,4,16003,16003,16003,49,2,0,1923,87,2010
2020-03-31,UT,887,17626,0,0,0,0,0,2020-03-31T20:00:00Z,5,18513,18513,18513,49,1,73,2429,81,2510
2020-04-01,UT,1012,20155,0,0,0,0,0,2020-04-01T20:00:00Z,7,21167,21167,21167,49,2,18,2529,125,2654
2020-04-02,UT,1074,20155,0,0,0,0,0,2020-04-02T20:00:00Z,7,21065,21167,21167,49,0,9,-164,62,-102
2020-04-03,UT,1246,23002,0,0,0,0,0,2020-04-03T20:00:00Z,7,24248,24248,24248,49,0,6,3011,172,3183
2020-04-04,UT,1428,26615,0,0,0,0,0,2020-04-04T20:00:00Z,8,28043,28043,28043,49,1,11,3613,182,3795
2020-04-05,UT,1605,29287,0,0,0,0,0,2020-04-05T20:00:00Z,8,30892,30892,30892,49,0,7,2672,177,2849
2020-04-06,UT,1675,31719,0,0,0,0,0,2020-04-06T20:00:00Z,13,33394,33394,33394,49,5,14,2432,70,2502
2020-03-05,VA,0,18,3,0,0,0,0,2020-03-05T21:00:00Z,0,21,18,18,51,0,0,0,0,0
2020-03-06,VA,0,21,10,0,0,0,0,2020-03-06T21:00:00Z,0,31,21,21,51,0,0,3,0,3
2020-03-07,VA,0,31,7,0,0,0,0,2020-03-07T21:00:00Z,0,38,31,31,51,0,0,10,0,10
2020-03-08,VA,2,36,6,0,0,0,0,2020-03-08T20:00:00Z,0,44,38,38,51,0,0,5,2,7
2020-03-09,VA,3,38,9,0,0,0,0,2020-03-09T20:00:00Z,0,50,41,41,51,0,0,2,1,3
2020-03-10,VA,8,53,0,0,0,0,0,2020-03-10T20:00:00Z,0,61,61,61,51,0,0,15,5,20
2020-03-11,VA,9,60,0,0,0,0,0,2020-03-11T20:00:00Z,0,69,69,69,51,0,0,7,1,8
2020-03-12,VA,17,117,0,0,0,0,0,2020-03-12T20:00:00Z,0,134,134,134,51,0,0,57,8,65
2020-03-13,VA,30,117,0,0,0,0,0,2020-03-13T20:00:00Z,0,147,147,147,51,0,0,0,13,13
2020-03-14,VA,30,117,0,0,0,0,0,2020-03-14T20:00:00Z,0,147,147,147,51,0,0,0,0,0
2020-03-15,VA,45,363,0,0,0,0,0,2020-03-15T20:00:00Z,1,408,408,408,51,1,0,246,15,261
2020-03-16,VA,51,438,0,0,0,0,0,2020-03-16T20:00:00Z,1,489,489,489,51,0,0,75,6,81
2020-03-17,VA,67,961,0,0,0,0,0,2020-03-17T20:00:00Z,1,1028,1028,1028,51,0,0,523,16,539
2020-03-18,VA,77,1201,0,0,0,0,0,2020-03-18T20:00:00Z,1,1278,1278,1278,51,0,0,240,10,250
2020-03-19,VA,94,1829,0,0,0,0,0,2020-03-19T20:00:00Z,2,1923,1923,1923,51,1,0,628,17,645
2020-03-20,VA,114,2211,0,0,0,0,0,2020-03-20T20:00:00Z,2,2325,2325,2325,51,0,0,382,20,402
2020-03-21,VA,152,2638,0,0,0,0,0,2020-03-21T20:00:00Z,2,2790,2790,2790,51,0,25,427,38,465
2020-03-22,VA,219,3118,0,0,0,0,0,2020-03-22T20:00:00Z,3,3337,3337,3337,51,1,7,480,67,547
2020-03-23,VA,254,3443,0,0,0,0,0,2020-03-23T20:00:00Z,6,3697,3697,3697,51,3,6,325,35,360
2020-03-24,VA,290,4180,0,0,0,0,0,2020-03-24T20:00:00Z,7,4470,4470,4470,51,1,7,737,36,773
2020-03-25,VA,391,4979,0,0,0,0,0,2020-03-25T20:00:00Z,9,5370,5370,5370,51,2,14,799,101,900
2020-03-26,VA,460,5729,0,0,0,0,0,2020-03-26T20:00:00Z,13,6189,6189,6189,51,4,6,750,69,819
2020-03-27,VA,604,6733,0,0,0,0,0,2020-03-27T20:00:00Z,14,7337,7337,7337,51,1,18,1004,144,1148
2020-03-28,VA,739,8427,0,0,0,0,0,2020-03-28T20:00:00Z,17,9166,9166,9166,51,3,16,1694,135,1829
2020-03-29,VA,890,9719,0,0,0,0,0,2020-03-29T20:00:00Z,22,10609,10609,10609,51,5,13,1292,151,1443
2020-03-30,VA,1020,11018,0,0,0,0,0,2020-03-30T20:00:00Z,25,12038,12038,12038,51,3,24,1299,130,1429
2020-03-31,VA,1250,12151,0,0,0,0,0,2020-03-31T20:00:00Z,27,13401,13401,13401,51,2,29,1133,230,1363
2020-04-01,VA,1484,13860,0,0,0,0,0,2020-04-01T20:00:00Z,34,15344,15344,15344,51,7,140,1709,234,1943
2020-04-02,VA,1706,15883,0,246,0,0,0,2020-04-02T20:00:00Z,41,17589,17589,17589,51,7,0,2023,222,2245
2020-04-03,VA,2012,16993,0,0,0,0,0,2020-04-03T20:00:00Z,46,19005,19005,19005,51,5,7,1110,306,1416
2020-04-04,VA,2407,19145,0,0,0,0,0,2020-04-04T20:00:00Z,52,21552,21552,21552,51,6,78,2152,395,2547
2020-04-05,VA,2637,21034,0,0,0,0,0,2020-04-05T20:00:00Z,52,23671,23671,23671,51,-1,41,1889,230,2119
2020-04-06,VA,2878,21643,0,0,0,0,0,2020-04-06T20:00:00Z,54,24521,24521,24521,51,3,66,609,241,850
2020-03-16,VI,1,0,0,0,0,0,0,2020-03-16T20:00:00Z,0,1,1,1,78,0,0,0,0,0
2020-03-17,VI,2,0,0,0,0,0,0,2020-03-17T20:00:00Z,0,2,2,2,78,0,0,0,1,1
2020-03-18,VI,2,0,0,0,0,0,0,2020-03-18T20:00:00Z,0,2,2,2,78,0,0,0,0,0
2020-03-19,VI,3,0,0,0,0,0,0,2020-03-19T20:00:00Z,0,3,3,3,78,0,0,0,1,1
2020-03-20,VI,3,0,0,0,0,0,0,2020-03-20T20:00:00Z,0,3,3,3,78,0,0,0,0,0
2020-03-21,VI,6,0,0,0,0,0,0,2020-03-21T20:00:00Z,0,6,6,6,78,0,0,0,3,3
2020-03-22,VI,6,0,0,0,0,0,0,2020-03-22T20:00:00Z,0,6,6,6,78,0,0,0,0,0
2020-03-23,VI,17,0,0,0,0,0,0,2020-03-23T20:00:00Z,0,17,17,17,78,0,0,0,11,11
2020-03-24,VI,17,0,0,0,0,0,0,2020-03-24T20:00:00Z,0,17,17,17,78,0,0,0,0,0
2020-03-25,VI,17,55,2,0,0,0,0,2020-03-25T20:00:00Z,0,74,72,72,78,0,0,55,0,55
2020-03-26,VI,17,55,2,0,0,0,0,2020-03-26T20:00:00Z,0,74,72,72,78,0,0,0,0,0
2020-03-27,VI,19,55,2,0,0,0,0,2020-03-27T20:00:00Z,0,76,74,74,78,0,0,0,2,2
2020-03-28,VI,22,106,55,0,0,0,0,2020-03-28T20:00:00Z,0,183,128,128,78,0,0,51,3,54
2020-03-29,VI,23,123,37,0,0,0,0,2020-03-29T20:00:00Z,0,183,146,146,78,0,0,17,1,18
2020-03-30,VI,30,126,24,0,0,0,0,2020-03-30T20:00:00Z,0,180,156,156,78,0,0,3,7,10
2020-03-31,VI,30,126,24,0,0,0,21,2020-03-31T20:00:00Z,0,180,156,156,78,0,0,0,0,0
2020-04-01,VI,30,126,24,0,0,0,21,2020-04-01T20:00:00Z,0,180,156,156,78,0,0,0,0,0
2020-04-02,VI,33,149,42,0,0,0,25,2020-04-02T20:00:00Z,0,224,182,182,78,0,0,23,3,26
2020-04-03,VI,38,154,56,0,0,0,29,2020-04-03T20:00:00Z,0,248,192,192,78,0,0,5,5,10
2020-04-04,VI,40,184,42,0,0,0,34,2020-04-04T20:00:00Z,0,266,224,224,78,0,0,30,2,32
2020-04-05,VI,42,206,18,0,0,0,34,2020-04-05T20:00:00Z,1,266,248,248,78,1,0,22,2,24
2020-04-06,VI,43,222,20,0,0,0,36,2020-04-06T20:00:00Z,1,285,265,265,78,0,0,16,1,17
2020-03-06,VT,0,8,0,0,0,0,0,2020-03-06T21:00:00Z,0,8,8,8,50,0,0,0,0,0
2020-03-07,VT,0,16,0,0,0,0,0,2020-03-07T21:00:00Z,0,16,16,16,50,0,0,8,0,8
2020-03-08,VT,1,28,0,0,0,0,0,2020-03-08T20:00:00Z,0,29,29,29,50,0,0,12,1,13
2020-03-09,VT,1,34,0,0,0,0,0,2020-03-09T20:00:00Z,0,35,35,35,50,0,0,6,0,6
2020-03-10,VT,1,40,0,0,0,0,0,2020-03-10T20:00:00Z,0,41,41,41,50,0,0,6,0,6
2020-03-11,VT,1,62,0,0,0,0,0,2020-03-11T20:00:00Z,0,63,63,63,50,0,0,22,0,22
2020-03-12,VT,2,97,0,0,0,0,0,2020-03-12T20:00:00Z,0,99,99,99,50,0,0,35,1,36
2020-03-13,VT,2,142,0,0,0,0,0,2020-03-13T20:00:00Z,0,144,144,144,50,0,0,45,0,45
2020-03-14,VT,4,227,0,0,0,0,0,2020-03-14T20:00:00Z,0,231,231,231,50,0,0,85,2,87
2020-03-15,VT,4,348,0,0,0,0,0,2020-03-15T20:00:00Z,0,352,352,352,50,0,0,121,0,121
2020-03-16,VT,8,421,0,0,0,0,0,2020-03-16T20:00:00Z,0,429,429,429,50,0,0,73,4,77
2020-03-17,VT,10,495,0,0,0,0,0,2020-03-17T20:00:00Z,0,505,505,505,50,0,0,74,2,76
2020-03-18,VT,19,592,0,0,0,0,0,2020-03-18T20:00:00Z,0,611,611,611,50,0,0,97,9,106
2020-03-19,VT,22,645,0,0,0,0,0,2020-03-19T20:00:00Z,0,667,667,667,50,0,0,53,3,56
2020-03-20,VT,29,779,0,0,0,0,0,2020-03-20T20:00:00Z,2,808,808,808,50,2,0,134,7,141
2020-03-21,VT,29,779,0,0,0,0,0,2020-03-21T20:00:00Z,2,808,808,808,50,0,0,0,0,0
2020-03-22,VT,52,1106,0,0,0,0,0,2020-03-22T20:00:00Z,2,1158,1158,1158,50,0,0,327,23,350
2020-03-23,VT,75,1106,0,0,0,0,0,2020-03-23T20:00:00Z,5,1181,1181,1181,50,3,0,0,23,23
2020-03-24,VT,95,1440,0,0,0,0,0,2020-03-24T20:00:00Z,7,1535,1535,1535,50,2,0,334,20,354
2020-03-25,VT,123,1589,0,0,0,0,0,2020-03-25T20:00:00Z,8,1712,1712,1712,50,1,0,149,28,177
2020-03-26,VT,158,1850,0,0,0,0,0,2020-03-26T20:00:00Z,9,2008,2008,2008,50,1,0,261,35,296
2020-03-27,VT,184,2077,0,0,0,0,0,2020-03-27T20:00:00Z,10,2261,2261,2261,50,1,18,227,26,253
2020-03-28,VT,211,2163,0,0,0,0,0,2020-03-28T20:00:00Z,12,2374,2374,2374,50,2,0,86,27,113
2020-03-29,VT,235,3466,0,0,0,0,0,2020-03-29T20:00:00Z,12,3701,3701,3701,50,0,0,1303,24,1327
2020-03-30,VT,256,3674,0,0,0,0,0,2020-03-30T20:00:00Z,12,3930,3930,3930,50,0,0,208,21,229
2020-03-31,VT,293,3957,0,21,0,0,15,2020-03-31T20:00:00Z,13,4250,4250,4250,50,1,18,283,37,320
2020-04-01,VT,321,4174,0,30,0,0,15,2020-04-01T20:00:00Z,16,4495,4495,4495,50,3,9,217,28,245
2020-04-02,VT,338,4711,0,29,0,0,15,2020-04-02T20:00:00Z,17,5049,5049,5049,50,1,0,537,17,554
2020-04-03,VT,389,4839,0,29,0,0,15,2020-04-03T20:00:00Z,17,5228,5228,5228,50,0,0,128,51,179
2020-04-04,VT,461,5383,0,29,0,0,15,2020-04-04T20:00:00Z,20,5844,5844,5844,50,3,0,544,72,616
2020-04-05,VT,512,6070,0,29,0,0,15,2020-04-05T20:00:00Z,22,6582,6582,6582,50,2,0,687,51,738
2020-04-06,VT,543,6090,0,28,0,0,15,2020-04-06T20:00:00Z,23,6633,6633,6633,50,1,0,20,31,51
2020-03-04,WA,39,0,0,0,0,0,0,2020-03-04T21:00:00Z,10,39,39,39,53,0,0,0,0,0
2020-03-05,WA,70,0,0,0,0,0,0,2020-03-05T21:00:00Z,11,70,70,70,53,1,0,0,31,31
2020-03-06,WA,79,370,0,0,0,0,0,2020-03-06T21:00:00Z,14,449,449,449,53,3,0,370,9,379
2020-03-07,WA,102,370,66,0,0,0,0,2020-03-07T21:00:00Z,16,538,472,472,53,2,0,0,23,23
2020-03-08,WA,102,640,60,0,0,0,0,2020-03-08T20:00:00Z,18,802,742,742,53,2,0,270,0,270
2020-03-09,WA,136,1110,0,0,0,0,0,2020-03-09T20:00:00Z,22,1246,1246,1246,53,4,0,470,34,504
2020-03-10,WA,162,1110,0,0,0,0,0,2020-03-10T20:00:00Z,24,1272,1272,1272,53,2,0,0,26,26
2020-03-11,WA,267,2175,0,0,0,0,0,2020-03-11T20:00:00Z,24,2442,2442,2442,53,0,0,1065,105,1170
2020-03-12,WA,337,3037,0,0,0,0,0,2020-03-12T20:00:00Z,29,3374,3374,3374,53,5,0,862,70,932
2020-03-13,WA,457,4350,0,0,0,0,0,2020-03-13T20:00:00Z,31,4807,4807,4807,53,2,0,1313,120,1433
2020-03-14,WA,568,6001,0,0,0,0,0,2020-03-14T20:00:00Z,37,6569,6569,6569,53,6,0,1651,111,1762
2020-03-15,WA,642,7122,0,0,0,0,0,2020-03-15T20:00:00Z,40,7764,7764,7764,53,3,0,1121,74,1195
2020-03-16,WA,769,9451,0,0,0,0,0,2020-03-16T20:00:00Z,42,10220,10220,10220,53,2,0,2329,127,2456
2020-03-17,WA,904,11582,0,0,0,0,0,2020-03-17T20:00:00Z,48,12486,12486,12486,53,6,0,2131,135,2266
2020-03-18,WA,1012,13117,0,0,0,0,0,2020-03-18T20:00:00Z,52,14129,14129,14129,53,4,0,1535,108,1643
2020-03-19,WA,1187,15918,0,0,0,0,0,2020-03-19T20:00:00Z,66,17105,17105,17105,53,14,0,2801,175,2976
2020-03-20,WA,1376,19336,0,0,0,0,0,2020-03-20T20:00:00Z,74,20712,20712,20712,53,8,0,3418,189,3607
2020-03-21,WA,1524,21719,0,0,0,0,0,2020-03-21T20:00:00Z,83,23243,23243,23243,53,9,0,2383,148,2531
2020-03-22,WA,1793,25328,0,0,0,0,0,2020-03-22T20:00:00Z,94,27121,27121,27121,53,11,0,3609,269,3878
2020-03-23,WA,1996,28879,0,0,0,0,0,2020-03-23T20:00:00Z,95,30875,30875,30875,53,1,0,3551,203,3754
2020-03-24,WA,2221,31712,0,0,0,0,0,2020-03-24T20:00:00Z,110,33933,33933,33933,53,15,0,2833,225,3058
2020-03-25,WA,2469,31712,0,0,0,0,0,2020-03-25T20:00:00Z,123,34181,34181,34181,53,13,0,0,248,248
2020-03-26,WA,2580,31712,0,0,0,0,0,2020-03-26T20:00:00Z,132,34292,34292,34292,53,9,0,0,111,111
2020-03-27,WA,3207,43173,0,0,0,0,0,2020-03-27T20:00:00Z,147,46380,46380,46380,53,15,0,11461,627,12088
2020-03-28,WA,3723,49015,0,0,0,0,0,2020-03-28T20:00:00Z,175,52738,52738,52738,53,28,254,5842,516,6358
2020-03-29,WA,4310,54896,0,0,0,0,0,2020-03-29T20:00:00Z,189,59206,59206,59206,53,14,0,5881,587,6468
2020-03-30,WA,4896,60566,0,0,0,0,0,2020-03-30T20:00:00Z,195,65462,65462,65462,53,6,0,5670,586,6256
2020-03-31,WA,4896,60566,0,0,0,0,0,2020-03-31T20:00:00Z,195,65462,65462,65462,53,0,0,0,0,0
2020-04-01,WA,5634,60566,0,0,0,0,0,2020-04-01T20:00:00Z,224,66200,66200,66200,53,29,0,0,738,738
2020-04-02,WA,5984,68814,0,0,0,0,0,2020-04-02T20:00:00Z,247,74798,74798,74798,53,23,0,8248,350,8598
2020-04-03,WA,6585,72833,0,0,0,0,0,2020-04-03T20:00:00Z,262,79418,79418,79418,53,15,0,4019,601,4620
2020-04-04,WA,6966,75633,0,0,0,0,0,2020-04-04T20:00:00Z,284,82599,82599,82599,53,22,0,2800,381,3181
2020-04-05,WA,7591,80327,0,0,0,0,0,2020-04-05T20:00:00Z,310,87918,87918,87918,53,26,0,4694,625,5319
2020-04-06,WA,7984,83391,0,0,0,0,0,2020-04-06T20:00:00Z,338,91375,91375,91375,53,28,0,3064,393,3457
2020-03-04,WI,1,19,6,0,0,0,0,2020-03-04T21:00:00Z,0,26,20,20,55,0,0,0,0,0
2020-03-05,WI,1,19,6,0,0,0,0,2020-03-05T21:00:00Z,0,26,20,20,55,0,0,0,0,0
2020-03-06,WI,1,31,12,0,0,0,0,2020-03-06T21:00:00Z,0,44,32,32,55,0,0,12,0,12
2020-03-07,WI,1,31,12,0,0,0,0,2020-03-07T21:00:00Z,0,44,32,32,55,0,0,0,0,0
2020-03-08,WI,1,31,12,0,0,0,0,2020-03-08T20:00:00Z,0,44,32,32,55,0,0,0,0,0
2020-03-09,WI,1,36,0,0,0,0,0,2020-03-09T20:00:00Z,0,37,37,37,55,0,0,5,0,5
2020-03-10,WI,2,36,0,0,0,0,0,2020-03-10T20:00:00Z,0,38,38,38,55,0,0,0,1,1
2020-03-11,WI,3,43,0,0,0,0,0,2020-03-11T20:00:00Z,0,46,46,46,55,0,0,7,1,8
2020-03-12,WI,8,84,0,0,0,0,0,2020-03-12T20:00:00Z,0,92,92,92,55,0,0,41,5,46
2020-03-13,WI,19,169,0,0,0,0,0,2020-03-13T20:00:00Z,0,188,188,188,55,0,0,85,11,96
2020-03-14,WI,19,169,0,0,0,0,0,2020-03-14T20:00:00Z,0,188,188,188,55,0,0,0,0,0
2020-03-15,WI,33,313,0,0,0,0,0,2020-03-15T20:00:00Z,0,346,346,346,55,0,0,144,14,158
2020-03-16,WI,47,504,0,0,0,0,0,2020-03-16T20:00:00Z,0,551,551,551,55,0,0,191,14,205
2020-03-17,WI,72,1038,0,0,0,0,0,2020-03-17T20:00:00Z,0,1110,1110,1110,55,0,0,534,25,559
2020-03-18,WI,106,1577,0,0,0,0,0,2020-03-18T20:00:00Z,0,1683,1683,1683,55,0,0,539,34,573
2020-03-19,WI,155,2192,0,0,0,0,0,2020-03-19T20:00:00Z,0,2347,2347,2347,55,0,0,615,49,664
2020-03-20,WI,206,3455,0,0,0,0,0,2020-03-20T20:00:00Z,3,3661,3661,3661,55,3,0,1263,51,1314
2020-03-21,WI,281,4628,0,0,0,0,0,2020-03-21T20:00:00Z,4,4909,4909,4909,55,1,0,1173,75,1248
2020-03-22,WI,385,6230,0,0,0,0,0,2020-03-22T20:00:00Z,4,6615,6615,6615,55,0,0,1602,104,1706
2020-03-23,WI,416,7050,0,0,0,0,0,2020-03-23T20:00:00Z,5,7466,7466,7466,55,1,0,820,31,851
2020-03-24,WI,457,8237,0,0,0,0,0,2020-03-24T20:00:00Z,5,8694,8694,8694,55,0,0,1187,41,1228
2020-03-25,WI,585,10089,0,0,0,0,0,2020-03-25T20:00:00Z,7,10674,10674,10674,55,2,0,1852,128,1980
2020-03-26,WI,707,11583,0,0,0,0,0,2020-03-26T20:00:00Z,8,12290,12290,12290,55,1,0,1494,122,1616
2020-03-27,WI,842,13140,0,0,0,0,0,2020-03-27T20:00:00Z,13,13982,13982,13982,55,5,0,1557,135,1692
2020-03-28,WI,989,15232,0,0,0,0,0,2020-03-28T20:00:00Z,13,16221,16221,16221,55,0,0,2092,147,2239
2020-03-29,WI,1112,16550,0,0,0,0,0,2020-03-29T20:00:00Z,13,17662,17662,17662,55,0,0,1318,123,1441
2020-03-30,WI,1221,16550,0,0,0,0,0,2020-03-30T20:00:00Z,14,17077,17662,17662,55,1,0,-694,109,-585
2020-03-31,WI,1351,17375,0,0,0,0,0,2020-03-31T20:00:00Z,16,18726,18726,18726,55,2,337,1519,130,1649
2020-04-01,WI,1550,18819,0,0,0,0,0,2020-04-01T20:00:00Z,24,20369,20369,20369,55,8,61,1444,199,1643
2020-04-02,WI,1730,20317,0,0,0,0,0,2020-04-02T20:00:00Z,31,22047,22047,22047,55,7,63,1498,180,1678
2020-04-03,WI,1912,22377,0,0,0,0,0,2020-04-03T20:00:00Z,37,24289,24289,24289,55,6,26,2060,182,2242
2020-04-04,WI,2112,23859,0,0,0,0,0,2020-04-04T20:00:00Z,56,25971,25971,25971,55,19,101,1482,200,1682
2020-04-05,WI,2267,25169,0,0,0,0,0,2020-04-05T20:00:00Z,68,27436,27436,27436,55,12,36,1310,155,1465
2020-04-06,WI,2440,26574,0,0,0,0,0,2020-04-06T20:00:00Z,77,29014,29014,29014,55,9,44,1405,173,1578
2020-03-06,WV,0,1,4,0,0,0,0,2020-03-06T21:00:00Z,0,5,1,1,54,0,0,0,0,0
2020-03-07,WV,0,2,3,0,0,0,0,2020-03-07T21:00:00Z,0,5,2,2,54,0,0,1,0,1
2020-03-08,WV,0,2,3,0,0,0,0,2020-03-08T20:00:00Z,0,5,2,2,54,0,0,0,0,0
2020-03-09,WV,0,2,3,0,0,0,0,2020-03-09T20:00:00Z,0,5,2,2,54,0,0,0,0,0
2020-03-10,WV,0,2,3,0,0,0,0,2020-03-10T20:00:00Z,0,5,2,2,54,0,0,0,0,0
2020-03-11,WV,0,3,2,0,0,0,0,2020-03-11T20:00:00Z,0,5,3,3,54,0,0,1,0,1
2020-03-12,WV,0,7,1,0,0,0,0,2020-03-12T20:00:00Z,0,8,7,7,54,0,0,4,0,4
2020-03-13,WV,0,17,4,0,0,0,0,2020-03-13T20:00:00Z,0,21,17,17,54,0,0,10,0,10
2020-03-14,WV,0,26,5,0,0,0,0,2020-03-14T20:00:00Z,0,31,26,26,54,0,0,9,0,9
2020-03-15,WV,0,38,1,0,0,0,0,2020-03-15T20:00:00Z,0,39,38,38,54,0,0,12,0,12
2020-03-16,WV,0,80,4,0,0,0,0,2020-03-16T20:00:00Z,0,84,80,80,54,0,0,42,0,42
2020-03-17,WV,0,80,4,0,0,0,0,2020-03-17T20:00:00Z,0,84,80,80,54,0,0,0,0,0
2020-03-18,WV,1,122,14,0,0,0,0,2020-03-18T20:00:00Z,0,137,123,123,54,0,0,42,1,43
2020-03-19,WV,2,143,3,0,0,0,0,2020-03-19T20:00:00Z,0,148,145,145,54,0,0,21,1,22
2020-03-20,WV,7,219,13,0,0,0,0,2020-03-20T20:00:00Z,0,239,226,226,54,0,0,76,5,81
2020-03-21,WV,11,330,2,0,0,0,0,2020-03-21T20:00:00Z,0,343,341,341,54,0,1,111,4,115
2020-03-22,WV,12,385,1,0,0,0,0,2020-03-22T20:00:00Z,0,398,397,397,54,0,0,55,1,56
2020-03-23,WV,16,444,4,0,0,0,0,2020-03-23T20:00:00Z,0,464,460,460,54,0,0,59,4,63
2020-03-24,WV,20,610,0,0,0,0,0,2020-03-24T20:00:00Z,0,630,630,630,54,0,0,166,4,170
2020-03-25,WV,39,759,6,0,0,0,0,2020-03-25T20:00:00Z,0,804,798,798,54,0,0,149,19,168
2020-03-26,WV,51,1031,19,0,0,0,0,2020-03-26T20:00:00Z,0,1101,1082,1082,54,0,0,272,12,284
2020-03-27,WV,76,1779,43,0,0,0,0,2020-03-27T20:00:00Z,0,1898,1855,1855,54,0,0,748,25,773
2020-03-28,WV,96,2331,6,0,0,0,0,2020-03-28T20:00:00Z,0,2433,2427,2427,54,0,0,552,20,572
2020-03-29,WV,113,2705,0,0,0,0,0,2020-03-29T20:00:00Z,0,2818,2818,2818,54,0,0,374,17,391
2020-03-30,WV,126,2984,0,0,0,0,0,2020-03-30T20:00:00Z,1,3110,3110,3110,54,1,0,279,13,292
2020-03-31,WV,162,3981,0,0,0,0,0,2020-03-31T20:00:00Z,1,4143,4143,4143,54,0,0,997,36,1033
2020-04-01,WV,191,4384,0,0,0,0,0,2020-04-01T20:00:00Z,1,4575,4575,4575,54,0,0,403,29,432
2020-04-02,WV,217,5276,0,0,0,0,0,2020-04-02T20:00:00Z,2,5493,5493,5493,54,1,0,892,26,918
2020-04-03,WV,237,6130,0,0,0,0,0,2020-04-03T20:00:00Z,2,6367,6367,6367,54,0,0,854,20,874
2020-04-04,WV,282,7404,0,0,0,0,0,2020-04-04T20:00:00Z,2,7686,7686,7686,54,0,0,1274,45,1319
2020-04-05,WV,324,8514,0,0,0,0,0,2020-04-05T20:00:00Z,3,8838,8838,8838,54,1,0,1110,42,1152
2020-04-06,WV,345,9595,0,0,0,0,0,2020-04-06T20:00:00Z,4,9940,9940,9940,54,1,0,1081,21,1102
2020-03-07,WY,0,0,0,0,0,0,0,2020-03-07T21:00:00Z,0,0,0,0,56,0,0,0,0,0
2020-03-08,WY,0,0,0,0,0,0,0,2020-03-08T20:00:00Z,0,0,0,0,56,0,0,0,0,0
2020-03-09,WY,0,0,0,0,0,0,0,2020-03-09T20:00:00Z,0,0,0,0,56,0,0,0,0,0
2020-03-10,WY,0,0,0,0,0,0,0,2020-03-10T20:00:00Z,0,0,0,0,56,0,0,0,0,0
2020-03-11,WY,0,0,0,0,0,0,0,2020-03-11T20:00:00Z,0,0,0,0,56,0,0,0,0,0
2020-03-12,WY,1,0,0,0,0,0,0,2020-03-12T20:00:00Z,0,1,1,1,56,0,0,0,1,1
2020-03-13,WY,1,0,0,0,0,0,0,2020-03-13T20:00:00Z,0,1,1,1,56,0,0,0,0,0
2020-03-14,WY,2,0,0,0,0,0,0,2020-03-14T20:00:00Z,0,2,2,2,56,0,0,0,1,1
2020-03-15,WY,3,0,0,0,0,0,0,2020-03-15T20:00:00Z,0,3,3,3,56,0,0,0,1,1
2020-03-16,WY,3,0,0,0,0,0,0,2020-03-16T20:00:00Z,0,3,3,3,56,0,0,0,0,0
2020-03-17,WY,10,95,0,0,0,0,0,2020-03-17T20:00:00Z,0,105,105,105,56,0,0,95,7,102
2020-03-18,WY,15,178,0,0,0,0,0,2020-03-18T20:00:00Z,0,193,193,193,56,0,0,83,5,88
2020-03-19,WY,18,271,0,0,0,0,0,2020-03-19T20:00:00Z,0,289,289,289,56,0,0,93,3,96
2020-03-20,WY,19,331,0,0,0,0,0,2020-03-20T20:00:00Z,0,350,350,350,56,0,0,60,1,61
2020-03-21,WY,23,438,0,0,0,0,0,2020-03-21T20:00:00Z,0,461,461,461,56,0,0,107,4,111
2020-03-22,WY,24,438,0,0,0,0,0,2020-03-22T20:00:00Z,0,462,462,462,56,0,0,0,1,1
2020-03-23,WY,26,592,0,0,0,0,0,2020-03-23T20:00:00Z,0,618,618,618,56,0,0,154,2,156
2020-03-24,WY,29,710,0,0,0,0,0,2020-03-24T20:00:00Z,0,739,739,739,56,0,0,118,3,121
2020-03-25,WY,44,954,0,0,0,0,7,2020-03-25T20:00:00Z,0,998,998,998,56,0,0,244,15,259
2020-03-26,WY,53,1052,0,0,0,0,12,2020-03-26T20:00:00Z,0,1105,1105,1105,56,0,0,98,9,107
2020-03-27,WY,70,1211,0,0,0,0,17,2020-03-27T20:00:00Z,0,1281,1281,1281,56,0,11,159,17,176
2020-03-28,WY,82,1475,0,0,0,0,18,2020-03-28T20:00:00Z,0,1557,1557,1557,56,0,3,264,12,276
2020-03-29,WY,86,1554,0,0,0,0,20,2020-03-29T20:00:00Z,0,1640,1640,1640,56,0,1,79,4,83
2020-03-30,WY,94,1840,0,0,0,0,24,2020-03-30T20:00:00Z,0,1934,1934,1934,56,0,2,286,8,294
2020-03-31,WY,109,1999,0,0,0,0,26,2020-03-31T20:00:00Z,0,2108,2108,2108,56,0,0,159,15,174
2020-04-01,WY,130,2218,0,0,0,0,31,2020-04-01T20:00:00Z,0,2348,2348,2348,56,0,1,219,21,240
2020-04-02,WY,150,2439,0,0,0,0,31,2020-04-02T20:00:00Z,0,2589,2589,2589,56,0,1,221,20,241
2020-04-03,WY,162,2704,0,0,0,0,37,2020-04-03T20:00:00Z,0,2866,2866,2866,56,0,2,265,12,277
2020-04-04,WY,187,2945,0,0,0,0,49,2020-04-04T20:00:00Z,0,3132,3132,3132,56,0,2,241,25,266
2020-04-05,WY,197,3040,0,0,0,0,50,2020-04-05T20:00:00Z,0,3237,3237,3237,56,0,0,95,10,105
2020-04-06,WY,210,3719,0,0,0,0,52,2020-04-06T20:00:00Z,0,3929,3929,3929,56,0,0,679,13,692
