date,state,positive,negative,pending,hospitalized,death,total,dateChecked,totalTestResults
2020-03-06,AK,0,8,1,0,0,9,2020-03-06T21:00:00Z,8
2020-03-07,AK,0,12,2,0,0,14,2020-03-07T21:00:00Z,12
2020-03-08,AK,0,14,6,0,0,20,2020-03-08T20:00:00Z,14
2020-03-09,AK,0,23,9,0,0,32,2020-03-09T20:00:00Z,23
2020-03-10,AK,0,23,9,0,0,32,2020-03-10T20:00:00Z,23
2020-03-11,AK,0,46,14,0,0,60,2020-03-11T20:00:00Z,46
2020-03-12,AK,0,46,14,0,0,60,2020-03-12T20:00:00Z,46
2020-03-13,AK,1,59,0,0,0,60,2020-03-13T20:00:00Z,60
2020-03-14,AK,1,143,0,0,0,144,2020-03-14T20:00:00Z,144
2020-03-15,AK,1,143,0,0,0,144,2020-03-15T20:00:00Z,144
2020-03-16,AK,1,143,0,0,0,144,2020-03-16T20:00:00Z,144
2020-03-17,AK,3,334,0,0,0,337,2020-03-17T20:00:00Z,337
2020-03-18,AK,6,406,0,0,0,412,2020-03-18T20:00:00Z,412
2020-03-19,AK,6,400,0,0,0,406,2020-03-19T20:00:00Z,406
2020-03-20,AK,12,686,0,0,0,698,2020-03-20T20:00:00Z,698
2020-03-21,AK,14,758,0,0,0,772,2020-03-21T20:00:00Z,772
2020-03-22,AK,22,946,0,0,0,968,2020-03-22T20:00:00Z,968
2020-03-23,AK,22,946,0,0,0,968,2020-03-23T20:00:00Z,968
2020-03-24,AK,36,986,0,0,0,1022,2020-03-24T20:00:00Z,1022
2020-03-07,AL,0,0,0,0,0,0,2020-03-07T21:00:00Z,0
2020-03-08,AL,0,0,0,0,0,0,2020-03-08T20:00:00Z,0
2020-03-09,AL,0,0,0,0,0,0,2020-03-09T20:00:00Z,0
2020-03-10,AL,0,0,0,0,0,0,2020-03-10T20:00:00Z,0
2020-03-11,AL,0,10,0,0,0,10,2020-03-11T20:00:00Z,10
2020-03-12,AL,0,10,0,0,0,10,2020-03-12T20:00:00Z,10
2020-03-13,AL,1,11,0,0,0,12,2020-03-13T20:00:00Z,12
2020-03-14,AL,6,22,46,0,0,74,2020-03-14T20:00:00Z,28
2020-03-15,AL,12,28,46,0,0,86,2020-03-15T20:00:00Z,40
2020-03-16,AL,28,28,40,0,0,96,2020-03-16T20:00:00Z,56
2020-03-17,AL,36,28,0,0,0,64,2020-03-17T20:00:00Z,64
2020-03-18,AL,46,28,0,0,0,74,2020-03-18T20:00:00Z,74
2020-03-19,AL,68,28,0,0,0,96,2020-03-19T20:00:00Z,96
2020-03-20,AL,81,28,0,0,0,109,2020-03-20T20:00:00Z,109
2020-03-21,AL,124,28,0,0,0,152,2020-03-21T20:00:00Z,152
2020-03-22,AL,138,1464,0,0,0,1602,2020-03-22T20:00:00Z,1602
2020-03-23,AL,167,1665,0,0,0,1832,2020-03-23T20:00:00Z,1832
2020-03-24,AL,215,2106,0,0,0,2321,2020-03-24T20:00:00Z,2321
2020-03-06,AR,0,6,0,0,0,6,2020-03-06T21:00:00Z,6
2020-03-07,AR,0,6,0,0,0,6,2020-03-07T21:00:00Z,6
2020-03-08,AR,0,6,0,0,0,6,2020-03-08T20:00:00Z,6
2020-03-09,AR,0,12,0,0,0,12,2020-03-09T20:00:00Z,12
2020-03-10,AR,0,12,3,0,0,15,2020-03-10T20:00:00Z,12
2020-03-11,AR,0,12,14,0,0,26,2020-03-11T20:00:00Z,12
2020-03-12,AR,6,24,20,0,0,50,2020-03-12T20:00:00Z,30
2020-03-13,AR,9,30,22,0,0,61,2020-03-13T20:00:00Z,39
2020-03-14,AR,12,65,26,0,0,103,2020-03-14T20:00:00Z,77
2020-03-15,AR,16,103,30,0,0,149,2020-03-15T20:00:00Z,119
2020-03-16,AR,22,132,14,0,0,168,2020-03-16T20:00:00Z,154
2020-03-17,AR,22,197,41,0,0,260,2020-03-17T20:00:00Z,219
2020-03-18,AR,33,236,50,0,0,319,2020-03-18T20:00:00Z,269
2020-03-19,AR,46,310,113,0,0,469,2020-03-19T20:00:00Z,356
2020-03-20,AR,96,351,203,0,0,650,2020-03-20T20:00:00Z,447
2020-03-21,AR,118,567,154,0,0,839,2020-03-21T20:00:00Z,685
2020-03-22,AR,165,711,119,13,0,995,2020-03-22T20:00:00Z,876
2020-03-23,AR,174,906,0,13,0,1080,2020-03-23T20:00:00Z,1080
2020-03-24,AR,218,947,0,22,0,1165,2020-03-24T20:00:00Z,1165
2020-03-16,AS,0,0,0,0,0,0,2020-03-16T20:00:00Z,0
2020-03-17,AS,0,0,0,0,0,0,2020-03-17T20:00:00Z,0
2020-03-18,AS,0,0,0,0,0,0,2020-03-18T20:00:00Z,0
2020-03-19,AS,0,0,0,0,0,0,2020-03-19T20:00:00Z,0
2020-03-20,AS,0,0,0,0,0,0,2020-03-20T20:00:00Z,0
2020-03-21,AS,0,0,0,0,0,0,2020-03-21T20:00:00Z,0
2020-03-22,AS,0,0,0,0,0,0,2020-03-22T20:00:00Z,0
2020-03-23,AS,0,0,0,0,0,0,2020-03-23T20:00:00Z,0
2020-03-24,AS,0,0,0,0,0,0,2020-03-24T20:00:00Z,0
2020-03-04,AZ,2,27,5,0,0,34,2020-03-04T21:00:00Z,29
2020-03-05,AZ,2,28,6,0,0,36,2020-03-05T21:00:00Z,30
2020-03-06,AZ,3,33,15,0,0,51,2020-03-06T21:00:00Z,36
2020-03-07,AZ,5,44,7,0,0,56,2020-03-07T21:00:00Z,49
2020-03-08,AZ,5,44,7,0,0,56,2020-03-08T20:00:00Z,49
2020-03-09,AZ,5,44,7,0,0,56,2020-03-09T20:00:00Z,49
2020-03-10,AZ,6,51,27,0,0,84,2020-03-10T20:00:00Z,57
2020-03-11,AZ,9,59,32,0,0,100,2020-03-11T20:00:00Z,68
2020-03-12,AZ,9,82,24,0,0,115,2020-03-12T20:00:00Z,91
2020-03-13,AZ,9,94,40,0,0,143,2020-03-13T20:00:00Z,103
2020-03-14,AZ,12,121,50,0,0,183,2020-03-14T20:00:00Z,133
2020-03-15,AZ,12,121,50,0,0,183,2020-03-15T20:00:00Z,133
2020-03-16,AZ,18,125,63,0,0,206,2020-03-16T20:00:00Z,143
2020-03-17,AZ,20,142,66,0,0,228,2020-03-17T20:00:00Z,162
2020-03-18,AZ,28,148,102,0,0,278,2020-03-18T20:00:00Z,176
2020-03-19,AZ,44,175,130,0,0,349,2020-03-19T20:00:00Z,219
2020-03-20,AZ,65,211,101,0,0,377,2020-03-20T20:00:00Z,276
2020-03-21,AZ,104,240,122,0,1,466,2020-03-21T20:00:00Z,344
2020-03-22,AZ,152,282,87,0,2,521,2020-03-22T20:00:00Z,434
2020-03-23,AZ,265,309,6,0,2,580,2020-03-23T20:00:00Z,574
2020-03-24,AZ,357,313,22,8,5,692,2020-03-24T20:00:00Z,670
2020-03-04,CA,53,462,0,0,0,515,2020-03-04T21:00:00Z,515
2020-03-05,CA,53,462,0,0,0,515,2020-03-05T21:00:00Z,515
2020-03-06,CA,60,462,0,0,0,522,2020-03-06T21:00:00Z,522
2020-03-07,CA,69,462,0,0,0,531,2020-03-07T21:00:00Z,531
2020-03-08,CA,88,462,0,0,0,550,2020-03-08T20:00:00Z,550
2020-03-09,CA,114,690,0,0,0,804,2020-03-09T20:00:00Z,804
2020-03-10,CA,133,690,0,0,0,823,2020-03-10T20:00:00Z,823
2020-03-11,CA,157,916,0,0,0,1073,2020-03-11T20:00:00Z,1073
2020-03-12,CA,202,916,0,0,4,1118,2020-03-12T20:00:00Z,1118
2020-03-13,CA,202,916,0,0,4,1118,2020-03-13T20:00:00Z,1118
2020-03-14,CA,252,916,0,0,5,1168,2020-03-14T20:00:00Z,1168
2020-03-15,CA,293,916,0,0,5,1209,2020-03-15T20:00:00Z,1209
2020-03-16,CA,335,7981,0,0,6,8316,2020-03-16T20:00:00Z,8316
2020-03-17,CA,483,7981,0,0,11,8407,2020-03-17T20:00:00Z,8464
2020-03-18,CA,611,7981,0,0,13,8592,2020-03-18T20:00:00Z,8592
2020-03-19,CA,924,8787,0,0,18,9711,2020-03-19T20:00:00Z,9711
2020-03-20,CA,1063,10424,0,0,20,11487,2020-03-20T20:00:00Z,11487
2020-03-21,CA,1279,11249,0,0,24,12528,2020-03-21T20:00:00Z,12528
2020-03-22,CA,1536,11304,0,0,27,12840,2020-03-22T20:00:00Z,12840
2020-03-23,CA,1733,12567,12100,0,27,26400,2020-03-23T20:00:00Z,14300
2020-03-24,CA,2102,13452,12100,0,40,27654,2020-03-24T20:00:00Z,15554
2020-03-05,CO,0,19,21,0,0,40,2020-03-05T21:00:00Z,19
2020-03-06,CO,2,46,30,0,0,78,2020-03-06T21:00:00Z,48
2020-03-07,CO,8,55,69,0,0,132,2020-03-07T21:00:00Z,63
2020-03-08,CO,8,104,0,0,0,112,2020-03-08T20:00:00Z,112
2020-03-09,CO,9,133,0,0,0,142,2020-03-09T20:00:00Z,142
2020-03-10,CO,12,142,1,0,0,155,2020-03-10T20:00:00Z,154
2020-03-11,CO,28,251,0,0,0,279,2020-03-11T20:00:00Z,279
2020-03-12,CO,45,298,0,0,0,343,2020-03-12T20:00:00Z,343
2020-03-13,CO,72,524,0,0,0,596,2020-03-13T20:00:00Z,596
2020-03-14,CO,101,610,0,0,1,711,2020-03-14T20:00:00Z,711
2020-03-15,CO,131,627,0,0,1,758,2020-03-15T20:00:00Z,758
2020-03-16,CO,131,627,0,0,1,758,2020-03-16T20:00:00Z,758
2020-03-17,CO,160,1056,0,0,1,1216,2020-03-17T20:00:00Z,1216
2020-03-18,CO,183,1617,0,0,2,1800,2020-03-18T20:00:00Z,1800
2020-03-19,CO,216,2112,0,0,2,2328,2020-03-19T20:00:00Z,2328
2020-03-20,CO,277,2675,0,0,3,2952,2020-03-20T20:00:00Z,2952
2020-03-21,CO,363,3317,0,44,4,3680,2020-03-21T20:00:00Z,3680
2020-03-22,CO,475,4075,0,49,5,4550,2020-03-22T20:00:00Z,4550
2020-03-23,CO,591,4845,0,58,6,5436,2020-03-23T20:00:00Z,5436
2020-03-24,CO,720,5504,0,72,7,6224,2020-03-24T20:00:00Z,6224
2020-03-07,CT,0,0,0,0,0,0,2020-03-07T21:00:00Z,0
2020-03-08,CT,1,29,8,0,0,38,2020-03-08T20:00:00Z,30
2020-03-09,CT,1,46,0,0,0,47,2020-03-09T20:00:00Z,47
2020-03-10,CT,2,54,0,0,0,56,2020-03-10T20:00:00Z,56
2020-03-11,CT,3,71,0,0,0,74,2020-03-11T20:00:00Z,74
2020-03-12,CT,6,89,0,0,0,95,2020-03-12T20:00:00Z,95
2020-03-13,CT,6,99,0,0,0,105,2020-03-13T20:00:00Z,105
2020-03-14,CT,11,125,0,0,0,136,2020-03-14T20:00:00Z,136
2020-03-15,CT,20,125,0,0,0,145,2020-03-15T20:00:00Z,145
2020-03-16,CT,26,125,0,0,0,151,2020-03-16T20:00:00Z,151
2020-03-17,CT,41,125,0,0,0,166,2020-03-17T20:00:00Z,166
2020-03-18,CT,68,125,0,0,0,193,2020-03-18T20:00:00Z,193
2020-03-19,CT,96,604,0,0,1,700,2020-03-19T20:00:00Z,700
2020-03-20,CT,194,604,0,0,3,798,2020-03-20T20:00:00Z,798
2020-03-21,CT,194,2106,0,0,4,2300,2020-03-21T20:00:00Z,2300
2020-03-22,CT,223,2877,0,43,5,3100,2020-03-22T20:00:00Z,3100
2020-03-23,CT,415,4085,0,54,10,4500,2020-03-23T20:00:00Z,4500
2020-03-24,CT,618,4682,0,71,12,5300,2020-03-24T20:00:00Z,5300
2020-03-05,DC,0,6,2,0,0,8,2020-03-05T21:00:00Z,6
2020-03-06,DC,0,8,1,0,0,9,2020-03-06T21:00:00Z,8
2020-03-07,DC,0,8,1,0,0,9,2020-03-07T21:00:00Z,8
2020-03-08,DC,1,10,0,0,0,11,2020-03-08T20:00:00Z,11
2020-03-09,DC,1,14,3,0,0,18,2020-03-09T20:00:00Z,15
2020-03-10,DC,5,17,2,0,0,24,2020-03-10T20:00:00Z,22
2020-03-11,DC,4,20,15,0,0,39,2020-03-11T20:00:00Z,24
2020-03-12,DC,10,20,0,0,0,30,2020-03-12T20:00:00Z,30
2020-03-13,DC,10,20,0,0,0,30,2020-03-13T20:00:00Z,30
2020-03-14,DC,10,49,10,0,0,69,2020-03-14T20:00:00Z,59
2020-03-15,DC,16,79,20,0,0,115,2020-03-15T20:00:00Z,95
2020-03-16,DC,17,96,7,0,0,120,2020-03-16T20:00:00Z,113
2020-03-17,DC,22,104,0,0,0,126,2020-03-17T20:00:00Z,126
2020-03-18,DC,31,138,1,0,0,170,2020-03-18T20:00:00Z,169
2020-03-19,DC,39,153,11,0,0,203,2020-03-19T20:00:00Z,192
2020-03-20,DC,71,501,1,0,1,573,2020-03-20T20:00:00Z,572
2020-03-21,DC,77,506,0,0,1,583,2020-03-21T20:00:00Z,583
2020-03-22,DC,98,957,0,0,1,1055,2020-03-22T20:00:00Z,1055
2020-03-23,DC,116,1113,0,0,2,1229,2020-03-23T20:00:00Z,1229
2020-03-24,DC,137,1195,2,0,2,1334,2020-03-24T20:00:00Z,1332
2020-03-06,DE,0,10,0,0,0,10,2020-03-06T21:00:00Z,10
2020-03-07,DE,0,10,0,0,0,10,2020-03-07T21:00:00Z,10
2020-03-08,DE,0,10,0,0,0,10,2020-03-08T20:00:00Z,10
2020-03-09,DE,0,15,3,0,0,18,2020-03-09T20:00:00Z,15
2020-03-10,DE,0,17,3,0,0,20,2020-03-10T20:00:00Z,17
2020-03-11,DE,1,17,2,0,0,20,2020-03-11T20:00:00Z,18
2020-03-12,DE,4,23,14,0,0,41,2020-03-12T20:00:00Z,27
2020-03-13,DE,4,30,10,0,0,44,2020-03-13T20:00:00Z,34
2020-03-14,DE,6,36,32,0,0,74,2020-03-14T20:00:00Z,42
2020-03-15,DE,6,36,32,0,0,74,2020-03-15T20:00:00Z,42
2020-03-16,DE,8,36,32,0,0,76,2020-03-16T20:00:00Z,44
2020-03-17,DE,16,36,0,0,0,52,2020-03-17T20:00:00Z,52
2020-03-18,DE,25,36,0,0,0,61,2020-03-18T20:00:00Z,61
2020-03-19,DE,30,36,0,0,0,66,2020-03-19T20:00:00Z,66
2020-03-20,DE,38,36,0,0,0,74,2020-03-20T20:00:00Z,74
2020-03-21,DE,45,36,0,0,0,81,2020-03-21T20:00:00Z,81
2020-03-22,DE,56,36,0,0,0,92,2020-03-22T20:00:00Z,92
2020-03-23,DE,68,36,0,0,0,104,2020-03-23T20:00:00Z,104
2020-03-24,DE,91,36,0,0,0,127,2020-03-24T20:00:00Z,127
2020-03-04,FL,2,24,16,0,0,42,2020-03-04T21:00:00Z,26
2020-03-05,FL,9,31,69,0,0,109,2020-03-05T21:00:00Z,40
2020-03-06,FL,9,55,51,0,0,115,2020-03-06T21:00:00Z,64
2020-03-07,FL,14,100,88,0,0,202,2020-03-07T21:00:00Z,114
2020-03-08,FL,17,118,108,0,0,243,2020-03-08T20:00:00Z,135
2020-03-09,FL,18,140,115,0,0,273,2020-03-09T20:00:00Z,158
2020-03-10,FL,19,222,155,0,0,396,2020-03-10T20:00:00Z,241
2020-03-11,FL,28,301,147,0,2,476,2020-03-11T20:00:00Z,329
2020-03-12,FL,32,301,147,0,2,480,2020-03-12T20:00:00Z,333
2020-03-13,FL,50,478,221,0,2,749,2020-03-13T20:00:00Z,528
2020-03-14,FL,77,478,221,0,3,776,2020-03-14T20:00:00Z,555
2020-03-15,FL,116,678,454,0,4,1248,2020-03-15T20:00:00Z,794
2020-03-16,FL,141,684,514,0,4,1339,2020-03-16T20:00:00Z,825
2020-03-17,FL,186,940,872,0,6,1998,2020-03-17T20:00:00Z,1126
2020-03-18,FL,314,1225,954,0,7,2493,2020-03-18T20:00:00Z,1539
2020-03-19,FL,390,1533,1019,0,8,2942,2020-03-19T20:00:00Z,1923
2020-03-20,FL,520,1870,1026,0,10,3416,2020-03-20T20:00:00Z,2390
2020-03-21,FL,658,6579,1002,158,12,8239,2020-03-21T20:00:00Z,7237
2020-03-22,FL,830,7990,963,185,13,9783,2020-03-22T20:00:00Z,8820
2020-03-23,FL,1171,11063,860,217,14,13094,2020-03-23T20:00:00Z,12234
2020-03-24,FL,1412,13127,1008,259,18,15547,2020-03-24T20:00:00Z,14539
2020-03-04,GA,2,0,0,0,0,2,2020-03-04T21:00:00Z,2
2020-03-05,GA,2,0,0,0,0,2,2020-03-05T21:00:00Z,2
2020-03-06,GA,2,0,0,0,0,2,2020-03-06T21:00:00Z,2
2020-03-07,GA,6,0,0,0,0,6,2020-03-07T21:00:00Z,6
2020-03-08,GA,7,0,0,0,0,7,2020-03-08T20:00:00Z,7
2020-03-09,GA,12,0,0,0,0,12,2020-03-09T20:00:00Z,12
2020-03-10,GA,17,0,0,0,0,17,2020-03-10T20:00:00Z,17
2020-03-11,GA,22,0,0,0,0,22,2020-03-11T20:00:00Z,22
2020-03-12,GA,31,0,0,0,0,31,2020-03-12T20:00:00Z,31
2020-03-13,GA,42,0,0,0,1,42,2020-03-13T20:00:00Z,42
2020-03-14,GA,66,0,0,0,1,66,2020-03-14T20:00:00Z,66
2020-03-15,GA,99,0,0,0,1,99,2020-03-15T20:00:00Z,99
2020-03-16,GA,121,0,0,0,1,121,2020-03-16T20:00:00Z,121
2020-03-17,GA,146,0,0,0,1,146,2020-03-17T20:00:00Z,146
2020-03-18,GA,197,1311,0,0,1,1508,2020-03-18T20:00:00Z,1508
2020-03-19,GA,287,1544,0,0,10,1831,2020-03-19T20:00:00Z,1831
2020-03-20,GA,420,1966,0,0,13,2386,2020-03-20T20:00:00Z,2386
2020-03-21,GA,507,2557,0,0,14,3064,2020-03-21T20:00:00Z,3064
2020-03-22,GA,600,3420,0,0,23,4020,2020-03-22T20:00:00Z,4020
2020-03-23,GA,772,4297,0,0,25,5069,2020-03-23T20:00:00Z,5069
2020-03-24,GA,1026,4458,0,0,32,5484,2020-03-24T20:00:00Z,5484
2020-03-16,GU,3,23,0,0,0,26,2020-03-16T20:00:00Z,26
2020-03-17,GU,5,41,0,0,0,46,2020-03-17T20:00:00Z,46
2020-03-18,GU,8,57,0,0,0,65,2020-03-18T20:00:00Z,65
2020-03-19,GU,12,69,0,0,0,81,2020-03-19T20:00:00Z,81
2020-03-20,GU,14,86,0,0,0,100,2020-03-20T20:00:00Z,100
2020-03-21,GU,15,108,0,0,0,123,2020-03-21T20:00:00Z,123
2020-03-22,GU,27,126,0,0,1,153,2020-03-22T20:00:00Z,153
2020-03-23,GU,29,161,0,0,1,190,2020-03-23T20:00:00Z,190
2020-03-24,GU,32,201,0,5,1,233,2020-03-24T20:00:00Z,233
2020-03-07,HI,1,0,0,0,0,1,2020-03-07T21:00:00Z,1
2020-03-08,HI,1,0,0,0,0,1,2020-03-08T20:00:00Z,1
2020-03-09,HI,2,0,0,0,0,2,2020-03-09T20:00:00Z,2
2020-03-10,HI,2,0,0,0,0,2,2020-03-10T20:00:00Z,2
2020-03-11,HI,2,0,0,0,0,2,2020-03-11T20:00:00Z,2
2020-03-12,HI,2,0,0,0,0,2,2020-03-12T20:00:00Z,2
2020-03-13,HI,2,0,0,0,0,2,2020-03-13T20:00:00Z,2
2020-03-14,HI,2,0,0,0,0,2,2020-03-14T20:00:00Z,2
2020-03-15,HI,2,0,0,0,0,2,2020-03-15T20:00:00Z,2
2020-03-16,HI,7,0,0,0,0,7,2020-03-16T20:00:00Z,7
2020-03-17,HI,10,0,0,0,0,10,2020-03-17T20:00:00Z,10
2020-03-18,HI,14,93,12,0,0,119,2020-03-18T20:00:00Z,107
2020-03-19,HI,16,93,9,0,0,118,2020-03-19T20:00:00Z,109
2020-03-20,HI,26,124,9,0,0,159,2020-03-20T20:00:00Z,150
2020-03-21,HI,37,124,9,0,0,170,2020-03-21T20:00:00Z,161
2020-03-22,HI,48,263,0,0,0,311,2020-03-22T20:00:00Z,311
2020-03-23,HI,56,2955,0,0,0,3011,2020-03-23T20:00:00Z,3011
2020-03-24,HI,77,3589,0,4,1,3666,2020-03-24T20:00:00Z,3666
2020-03-06,IA,0,15,2,0,0,17,2020-03-06T21:00:00Z,15
2020-03-07,IA,0,15,2,0,0,17,2020-03-07T21:00:00Z,15
2020-03-08,IA,0,15,2,0,0,17,2020-03-08T20:00:00Z,15
2020-03-09,IA,3,26,8,0,0,37,2020-03-09T20:00:00Z,29
2020-03-10,IA,8,32,11,0,0,51,2020-03-10T20:00:00Z,40
2020-03-11,IA,13,46,27,0,0,86,2020-03-11T20:00:00Z,59
2020-03-12,IA,14,67,24,0,0,105,2020-03-12T20:00:00Z,81
2020-03-13,IA,16,83,29,0,0,128,2020-03-13T20:00:00Z,99
2020-03-14,IA,17,83,0,0,0,100,2020-03-14T20:00:00Z,100
2020-03-15,IA,18,83,0,0,0,101,2020-03-15T20:00:00Z,101
2020-03-16,IA,22,83,0,0,0,105,2020-03-16T20:00:00Z,105
2020-03-17,IA,23,83,0,0,0,106,2020-03-17T20:00:00Z,106
2020-03-18,IA,29,83,0,0,0,112,2020-03-18T20:00:00Z,112
2020-03-19,IA,38,83,0,0,0,121,2020-03-19T20:00:00Z,121
2020-03-20,IA,45,642,0,0,0,687,2020-03-20T20:00:00Z,687
2020-03-21,IA,68,1049,0,0,0,1117,2020-03-21T20:00:00Z,1117
2020-03-22,IA,90,1215,0,0,0,1305,2020-03-22T20:00:00Z,1305
2020-03-23,IA,105,2043,0,0,0,2148,2020-03-23T20:00:00Z,2148
2020-03-24,IA,124,2315,0,27,0,2439,2020-03-24T20:00:00Z,2439
2020-03-07,ID,0,27,0,0,0,27,2020-03-07T21:00:00Z,27
2020-03-08,ID,0,27,0,0,0,27,2020-03-08T20:00:00Z,27
2020-03-09,ID,0,41,0,0,0,41,2020-03-09T20:00:00Z,41
2020-03-10,ID,0,41,0,0,0,41,2020-03-10T20:00:00Z,41
2020-03-11,ID,0,67,0,0,0,67,2020-03-11T20:00:00Z,67
2020-03-12,ID,0,93,0,0,0,93,2020-03-12T20:00:00Z,93
2020-03-13,ID,0,131,0,0,0,131,2020-03-13T20:00:00Z,131
2020-03-14,ID,2,174,0,0,0,176,2020-03-14T20:00:00Z,176
2020-03-15,ID,5,171,0,0,0,176,2020-03-15T20:00:00Z,176
2020-03-16,ID,5,265,0,0,0,270,2020-03-16T20:00:00Z,270
2020-03-17,ID,7,346,0,0,0,353,2020-03-17T20:00:00Z,353
2020-03-18,ID,9,459,0,0,0,468,2020-03-18T20:00:00Z,468
2020-03-19,ID,11,457,0,0,0,468,2020-03-19T20:00:00Z,468
2020-03-20,ID,23,590,0,0,0,613,2020-03-20T20:00:00Z,613
2020-03-21,ID,31,880,0,0,0,911,2020-03-21T20:00:00Z,911
2020-03-22,ID,42,1175,0,0,0,1217,2020-03-22T20:00:00Z,1217
2020-03-23,ID,47,1309,0,0,0,1356,2020-03-23T20:00:00Z,1356
2020-03-24,ID,50,1887,0,0,0,1937,2020-03-24T20:00:00Z,1937
2020-03-04,IL,4,124,27,0,0,155,2020-03-04T21:00:00Z,128
2020-03-05,IL,5,165,27,0,0,197,2020-03-05T21:00:00Z,170
2020-03-06,IL,5,180,35,0,0,220,2020-03-06T21:00:00Z,185
2020-03-07,IL,6,191,44,0,0,241,2020-03-07T21:00:00Z,197
2020-03-08,IL,6,191,44,0,0,241,2020-03-08T20:00:00Z,197
2020-03-09,IL,7,191,44,0,0,242,2020-03-09T20:00:00Z,198
2020-03-10,IL,19,244,63,0,0,326,2020-03-10T20:00:00Z,263
2020-03-11,IL,19,244,63,0,0,326,2020-03-11T20:00:00Z,263
2020-03-12,IL,25,266,76,0,0,367,2020-03-12T20:00:00Z,291
2020-03-13,IL,32,294,92,0,0,418,2020-03-13T20:00:00Z,326
2020-03-14,IL,46,316,82,0,0,444,2020-03-14T20:00:00Z,362
2020-03-15,IL,64,449,195,0,0,708,2020-03-15T20:00:00Z,513
2020-03-16,IL,93,932,0,0,0,1025,2020-03-16T20:00:00Z,1025
2020-03-17,IL,160,1340,0,0,1,1500,2020-03-17T20:00:00Z,1500
2020-03-18,IL,289,1763,0,0,1,2052,2020-03-18T20:00:00Z,2052
2020-03-19,IL,426,2725,0,0,4,3151,2020-03-19T20:00:00Z,3151
2020-03-20,IL,590,3696,0,0,5,4286,2020-03-20T20:00:00Z,4286
2020-03-21,IL,759,5488,0,0,6,6247,2020-03-21T20:00:00Z,6247
2020-03-22,IL,1058,7271,0,0,9,8329,2020-03-22T20:00:00Z,8329
2020-03-23,IL,1285,8583,0,0,12,9868,2020-03-23T20:00:00Z,9868
2020-03-24,IL,1551,9934,0,0,16,11485,2020-03-24T20:00:00Z,11485
2020-03-06,IN,1,0,0,0,0,1,2020-03-06T21:00:00Z,1
2020-03-07,IN,1,0,0,0,0,1,2020-03-07T21:00:00Z,1
2020-03-08,IN,2,0,0,0,0,2,2020-03-08T20:00:00Z,2
2020-03-09,IN,2,0,0,0,0,2,2020-03-09T20:00:00Z,2
2020-03-10,IN,6,30,0,0,0,36,2020-03-10T20:00:00Z,36
2020-03-11,IN,10,33,0,0,0,43,2020-03-11T20:00:00Z,43
2020-03-12,IN,12,52,0,0,0,64,2020-03-12T20:00:00Z,64
2020-03-13,IN,12,61,0,0,0,73,2020-03-13T20:00:00Z,73
2020-03-14,IN,15,74,0,0,0,89,2020-03-14T20:00:00Z,89
2020-03-15,IN,19,102,0,0,0,121,2020-03-15T20:00:00Z,121
2020-03-16,IN,24,115,0,0,1,139,2020-03-16T20:00:00Z,139
2020-03-17,IN,30,129,0,0,2,159,2020-03-17T20:00:00Z,159
2020-03-18,IN,39,154,0,0,2,193,2020-03-18T20:00:00Z,193
2020-03-19,IN,56,324,0,0,2,380,2020-03-19T20:00:00Z,380
2020-03-20,IN,79,475,0,0,2,554,2020-03-20T20:00:00Z,554
2020-03-21,IN,126,707,0,1,4,833,2020-03-21T20:00:00Z,833
2020-03-22,IN,201,1293,0,1,6,1494,2020-03-22T20:00:00Z,1494
2020-03-23,IN,259,1701,0,1,7,1960,2020-03-23T20:00:00Z,1960
2020-03-24,IN,365,2566,0,1,12,2931,2020-03-24T20:00:00Z,2931
2020-03-06,KS,0,4,0,0,0,4,2020-03-06T21:00:00Z,4
2020-03-07,KS,0,11,2,0,0,13,2020-03-07T21:00:00Z,11
2020-03-08,KS,1,11,0,0,0,12,2020-03-08T20:00:00Z,12
2020-03-09,KS,1,11,0,0,0,12,2020-03-09T20:00:00Z,12
2020-03-10,KS,1,17,21,0,0,39,2020-03-10T20:00:00Z,18
2020-03-11,KS,1,41,0,0,0,42,2020-03-11T20:00:00Z,42
2020-03-12,KS,4,41,0,0,0,45,2020-03-12T20:00:00Z,45
2020-03-13,KS,6,93,0,0,0,99,2020-03-13T20:00:00Z,99
2020-03-14,KS,6,93,0,0,1,100,2020-03-14T20:00:00Z,99
2020-03-15,KS,8,135,0,0,1,143,2020-03-15T20:00:00Z,143
2020-03-16,KS,11,166,0,0,1,177,2020-03-16T20:00:00Z,177
2020-03-17,KS,15,382,0,0,1,397,2020-03-17T20:00:00Z,397
2020-03-18,KS,16,417,0,0,1,433,2020-03-18T20:00:00Z,433
2020-03-19,KS,34,417,0,0,1,451,2020-03-19T20:00:00Z,451
2020-03-20,KS,44,417,0,0,1,461,2020-03-20T20:00:00Z,461
2020-03-21,KS,55,417,0,0,2,472,2020-03-21T20:00:00Z,472
2020-03-22,KS,64,417,0,0,2,481,2020-03-22T20:00:00Z,481
2020-03-23,KS,82,417,0,0,2,499,2020-03-23T20:00:00Z,499
2020-03-24,KS,98,2086,0,0,2,2184,2020-03-24T20:00:00Z,2184
2020-03-06,KY,0,7,3,0,0,10,2020-03-06T21:00:00Z,7
2020-03-07,KY,1,9,0,0,0,10,2020-03-07T21:00:00Z,10
2020-03-08,KY,1,13,0,0,0,14,2020-03-08T20:00:00Z,14
2020-03-09,KY,4,17,0,0,0,21,2020-03-09T20:00:00Z,21
2020-03-10,KY,6,28,0,0,0,34,2020-03-10T20:00:00Z,34
2020-03-11,KY,8,46,0,0,0,54,2020-03-11T20:00:00Z,54
2020-03-12,KY,8,56,0,0,0,64,2020-03-12T20:00:00Z,64
2020-03-13,KY,11,107,0,0,0,118,2020-03-13T20:00:00Z,118
2020-03-14,KY,14,139,0,0,0,153,2020-03-14T20:00:00Z,153
2020-03-15,KY,16,139,0,0,0,155,2020-03-15T20:00:00Z,155
2020-03-16,KY,21,234,0,0,1,255,2020-03-16T20:00:00Z,255
2020-03-17,KY,22,295,0,0,1,317,2020-03-17T20:00:00Z,317
2020-03-18,KY,26,354,0,0,1,380,2020-03-18T20:00:00Z,380
2020-03-19,KY,35,454,0,0,1,489,2020-03-19T20:00:00Z,489
2020-03-20,KY,47,592,0,0,1,639,2020-03-20T20:00:00Z,639
2020-03-21,KY,54,714,0,0,2,768,2020-03-21T20:00:00Z,768
2020-03-22,KY,99,1472,0,0,3,1571,2020-03-22T20:00:00Z,1571
2020-03-23,KY,104,1762,0,0,3,1866,2020-03-23T20:00:00Z,1866
2020-03-24,KY,124,1742,0,0,4,1866,2020-03-24T20:00:00Z,1866
2020-03-07,LA,0,0,0,0,0,0,2020-03-07T21:00:00Z,0
2020-03-08,LA,0,5,0,0,0,5,2020-03-08T20:00:00Z,5
2020-03-09,LA,1,5,0,0,0,6,2020-03-09T20:00:00Z,6
2020-03-10,LA,1,11,0,0,0,12,2020-03-10T20:00:00Z,12
2020-03-11,LA,6,37,0,0,0,43,2020-03-11T20:00:00Z,43
2020-03-12,LA,14,37,0,0,0,51,2020-03-12T20:00:00Z,51
2020-03-13,LA,36,37,0,0,0,73,2020-03-13T20:00:00Z,73
2020-03-14,LA,69,109,0,0,0,178,2020-03-14T20:00:00Z,178
2020-03-15,LA,91,156,0,0,2,247,2020-03-15T20:00:00Z,247
2020-03-16,LA,114,188,0,0,2,302,2020-03-16T20:00:00Z,302
2020-03-17,LA,171,286,0,0,4,457,2020-03-17T20:00:00Z,457
2020-03-18,LA,240,335,0,0,6,575,2020-03-18T20:00:00Z,575
2020-03-19,LA,347,458,0,0,8,805,2020-03-19T20:00:00Z,805
2020-03-20,LA,479,568,0,0,12,1047,2020-03-20T20:00:00Z,1047
2020-03-21,LA,585,2180,0,0,16,2765,2020-03-21T20:00:00Z,2765
2020-03-22,LA,837,2661,0,0,20,3498,2020-03-22T20:00:00Z,3498
2020-03-23,LA,1172,4776,0,0,34,5948,2020-03-23T20:00:00Z,5948
2020-03-24,LA,1388,7215,0,271,46,8603,2020-03-24T20:00:00Z,8603
2020-03-04,MA,2,0,0,0,0,2,2020-03-04T21:00:00Z,2
2020-03-05,MA,2,0,0,0,0,2,2020-03-05T21:00:00Z,2
2020-03-06,MA,8,0,0,0,0,8,2020-03-06T21:00:00Z,8
2020-03-07,MA,13,0,0,0,0,13,2020-03-07T21:00:00Z,13
2020-03-08,MA,13,0,0,0,0,13,2020-03-08T20:00:00Z,13
2020-03-09,MA,41,0,0,0,0,41,2020-03-09T20:00:00Z,41
2020-03-10,MA,92,0,0,0,0,92,2020-03-10T20:00:00Z,92
2020-03-11,MA,92,0,0,0,0,92,2020-03-11T20:00:00Z,92
2020-03-12,MA,95,0,0,0,0,95,2020-03-12T20:00:00Z,95
2020-03-13,MA,123,92,0,0,0,215,2020-03-13T20:00:00Z,215
2020-03-14,MA,138,352,0,0,0,490,2020-03-14T20:00:00Z,490
2020-03-15,MA,138,352,0,0,0,490,2020-03-15T20:00:00Z,490
2020-03-16,MA,164,352,0,0,0,516,2020-03-16T20:00:00Z,516
2020-03-17,MA,218,1541,0,0,0,1759,2020-03-17T20:00:00Z,1759
2020-03-18,MA,256,2015,0,0,0,2271,2020-03-18T20:00:00Z,2271
2020-03-19,MA,328,2804,0,0,0,3132,2020-03-19T20:00:00Z,3132
2020-03-20,MA,413,3678,0,0,1,4091,2020-03-20T20:00:00Z,4091
2020-03-21,MA,525,4752,0,61,1,5277,2020-03-21T20:00:00Z,5277
2020-03-22,MA,646,5459,0,71,5,6105,2020-03-22T20:00:00Z,6105
2020-03-23,MA,777,8145,0,79,9,8922,2020-03-23T20:00:00Z,8922
2020-03-24,MA,1159,12590,0,94,11,13749,2020-03-24T20:00:00Z,13749
2020-03-05,MD,0,17,14,0,0,31,2020-03-05T21:00:00Z,17
2020-03-06,MD,3,26,12,0,0,41,2020-03-06T21:00:00Z,29
2020-03-07,MD,3,41,0,0,0,44,2020-03-07T21:00:00Z,44
2020-03-08,MD,3,52,0,0,0,55,2020-03-08T20:00:00Z,55
2020-03-09,MD,5,73,0,0,0,78,2020-03-09T20:00:00Z,78
2020-03-10,MD,6,89,0,0,0,95,2020-03-10T20:00:00Z,95
2020-03-11,MD,9,94,0,0,0,103,2020-03-11T20:00:00Z,103
2020-03-12,MD,12,94,0,0,0,106,2020-03-12T20:00:00Z,106
2020-03-13,MD,17,94,0,0,0,111,2020-03-13T20:00:00Z,111
2020-03-14,MD,26,94,0,0,0,120,2020-03-14T20:00:00Z,120
2020-03-15,MD,31,94,0,0,0,125,2020-03-15T20:00:00Z,125
2020-03-16,MD,37,94,0,0,0,131,2020-03-16T20:00:00Z,131
2020-03-17,MD,57,94,0,0,0,151,2020-03-17T20:00:00Z,151
2020-03-18,MD,85,94,0,0,0,179,2020-03-18T20:00:00Z,179
2020-03-19,MD,107,94,0,0,1,201,2020-03-19T20:00:00Z,201
2020-03-20,MD,149,94,0,0,1,243,2020-03-20T20:00:00Z,243
2020-03-21,MD,190,94,0,0,2,284,2020-03-21T20:00:00Z,284
2020-03-22,MD,244,94,0,0,3,338,2020-03-22T20:00:00Z,338
2020-03-23,MD,288,94,0,0,3,382,2020-03-23T20:00:00Z,382
2020-03-24,MD,349,94,0,0,3,443,2020-03-24T20:00:00Z,443
2020-03-07,ME,0,1,0,0,0,1,2020-03-07T21:00:00Z,1
2020-03-08,ME,0,1,0,0,0,1,2020-03-08T20:00:00Z,1
2020-03-09,ME,0,1,0,0,0,1,2020-03-09T20:00:00Z,1
2020-03-10,ME,0,20,5,0,0,25,2020-03-10T20:00:00Z,20
2020-03-11,ME,0,42,5,0,0,47,2020-03-11T20:00:00Z,42
2020-03-12,ME,1,65,20,0,0,86,2020-03-12T20:00:00Z,66
2020-03-13,ME,3,91,17,0,0,111,2020-03-13T20:00:00Z,94
2020-03-14,ME,3,91,17,0,0,111,2020-03-14T20:00:00Z,94
2020-03-15,ME,3,91,17,0,0,111,2020-03-15T20:00:00Z,94
2020-03-16,ME,17,764,0,0,0,781,2020-03-16T20:00:00Z,781
2020-03-17,ME,32,1303,0,0,0,1335,2020-03-17T20:00:00Z,1335
2020-03-18,ME,43,1670,0,0,0,1713,2020-03-18T20:00:00Z,1713
2020-03-19,ME,53,2004,0,0,0,2057,2020-03-19T20:00:00Z,2057
2020-03-20,ME,57,2264,0,0,0,2321,2020-03-20T20:00:00Z,2321
2020-03-21,ME,73,2264,0,0,0,2337,2020-03-21T20:00:00Z,2337
2020-03-22,ME,89,2264,0,0,0,2353,2020-03-22T20:00:00Z,2353
2020-03-23,ME,107,2791,0,0,0,2898,2020-03-23T20:00:00Z,2898
2020-03-24,ME,125,3014,0,0,0,3139,2020-03-24T20:00:00Z,3139
2020-03-05,MI,0,8,0,0,0,8,2020-03-05T21:00:00Z,8
2020-03-06,MI,0,8,8,0,0,16,2020-03-06T21:00:00Z,8
2020-03-07,MI,0,18,9,0,0,27,2020-03-07T21:00:00Z,18
2020-03-08,MI,0,26,10,0,0,36,2020-03-08T20:00:00Z,26
2020-03-09,MI,0,36,11,0,0,47,2020-03-09T20:00:00Z,36
2020-03-10,MI,0,39,24,0,0,63,2020-03-10T20:00:00Z,39
2020-03-11,MI,2,57,18,0,0,77,2020-03-11T20:00:00Z,59
2020-03-12,MI,2,91,27,0,0,120,2020-03-12T20:00:00Z,93
2020-03-13,MI,16,133,26,0,0,175,2020-03-13T20:00:00Z,149
2020-03-14,MI,25,205,26,0,0,256,2020-03-14T20:00:00Z,230
2020-03-15,MI,33,205,26,0,0,264,2020-03-15T20:00:00Z,238
2020-03-16,MI,53,272,30,0,0,355,2020-03-16T20:00:00Z,325
2020-03-17,MI,65,272,0,0,0,337,2020-03-17T20:00:00Z,337
2020-03-18,MI,80,272,0,0,0,352,2020-03-18T20:00:00Z,352
2020-03-19,MI,336,2113,0,0,3,2449,2020-03-19T20:00:00Z,2449
2020-03-20,MI,549,2069,0,0,3,2618,2020-03-20T20:00:00Z,2618
2020-03-21,MI,787,2069,0,0,5,2856,2020-03-21T20:00:00Z,2856
2020-03-22,MI,1035,2069,0,0,8,3104,2020-03-22T20:00:00Z,3104
2020-03-23,MI,1328,2069,0,0,15,3397,2020-03-23T20:00:00Z,3397
2020-03-24,MI,1791,2069,0,0,24,3860,2020-03-24T20:00:00Z,3860
2020-03-06,MN,0,36,0,0,0,36,2020-03-06T21:00:00Z,36
2020-03-07,MN,1,48,0,0,0,49,2020-03-07T21:00:00Z,49
2020-03-08,MN,1,48,0,0,0,49,2020-03-08T20:00:00Z,49
2020-03-09,MN,2,80,0,0,0,82,2020-03-09T20:00:00Z,82
2020-03-10,MN,3,132,0,0,0,135,2020-03-10T20:00:00Z,135
2020-03-11,MN,5,217,0,0,0,222,2020-03-11T20:00:00Z,222
2020-03-12,MN,9,307,0,0,0,316,2020-03-12T20:00:00Z,316
2020-03-13,MN,14,541,0,0,0,555,2020-03-13T20:00:00Z,555
2020-03-14,MN,21,847,0,0,0,868,2020-03-14T20:00:00Z,868
2020-03-15,MN,35,1387,0,0,0,1422,2020-03-15T20:00:00Z,1422
2020-03-16,MN,54,1839,0,0,0,1893,2020-03-16T20:00:00Z,1893
2020-03-17,MN,60,2276,0,0,0,2336,2020-03-17T20:00:00Z,2336
2020-03-18,MN,77,2685,0,0,0,2762,2020-03-18T20:00:00Z,2762
2020-03-19,MN,89,2949,0,0,0,3038,2020-03-19T20:00:00Z,3038
2020-03-20,MN,115,3741,0,0,0,3856,2020-03-20T20:00:00Z,3856
2020-03-21,MN,138,3952,0,0,1,4090,2020-03-21T20:00:00Z,4090
2020-03-22,MN,169,4511,0,12,1,4680,2020-03-22T20:00:00Z,4680
2020-03-23,MN,235,4511,0,17,1,4746,2020-03-23T20:00:00Z,4746
2020-03-24,MN,262,5550,0,21,1,5812,2020-03-24T20:00:00Z,5812
2020-03-07,MO,0,0,0,0,0,0,2020-03-07T21:00:00Z,0
2020-03-08,MO,1,0,0,0,0,1,2020-03-08T20:00:00Z,1
2020-03-09,MO,1,0,0,0,0,1,2020-03-09T20:00:00Z,1
2020-03-10,MO,1,0,0,0,0,1,2020-03-10T20:00:00Z,1
2020-03-11,MO,1,0,0,0,0,1,2020-03-11T20:00:00Z,1
2020-03-12,MO,1,64,0,0,0,65,2020-03-12T20:00:00Z,65
2020-03-13,MO,2,71,0,0,0,73,2020-03-13T20:00:00Z,73
2020-03-14,MO,4,90,0,0,0,94,2020-03-14T20:00:00Z,94
2020-03-15,MO,5,122,0,0,0,127,2020-03-15T20:00:00Z,127
2020-03-16,MO,6,164,0,0,0,170,2020-03-16T20:00:00Z,170
2020-03-17,MO,8,207,0,0,0,215,2020-03-17T20:00:00Z,215
2020-03-18,MO,13,253,0,0,0,266,2020-03-18T20:00:00Z,266
2020-03-19,MO,24,308,0,0,1,332,2020-03-19T20:00:00Z,332
2020-03-20,MO,47,369,0,0,1,416,2020-03-20T20:00:00Z,416
2020-03-21,MO,73,369,0,0,3,442,2020-03-21T20:00:00Z,442
2020-03-22,MO,90,369,0,0,3,459,2020-03-22T20:00:00Z,459
2020-03-23,MO,183,369,0,0,3,552,2020-03-23T20:00:00Z,552
2020-03-24,MO,183,369,0,0,3,552,2020-03-24T20:00:00Z,552
2020-03-16,MP,0,0,0,0,0,0,2020-03-16T20:00:00Z,0
2020-03-17,MP,0,0,0,0,0,0,2020-03-17T20:00:00Z,0
2020-03-18,MP,0,0,0,0,0,0,2020-03-18T20:00:00Z,0
2020-03-19,MP,0,0,0,0,0,0,2020-03-19T20:00:00Z,0
2020-03-20,MP,0,0,0,0,0,0,2020-03-20T20:00:00Z,0
2020-03-21,MP,0,0,0,0,0,0,2020-03-21T20:00:00Z,0
2020-03-22,MP,0,0,0,0,0,0,2020-03-22T20:00:00Z,0
2020-03-23,MP,0,0,0,0,0,0,2020-03-23T20:00:00Z,0
2020-03-24,MP,0,0,0,0,0,0,2020-03-24T20:00:00Z,0
2020-03-07,MS,0,0,0,0,0,0,2020-03-07T21:00:00Z,0
2020-03-08,MS,0,0,0,0,0,0,2020-03-08T20:00:00Z,0
2020-03-09,MS,0,0,0,0,0,0,2020-03-09T20:00:00Z,0
2020-03-10,MS,0,0,0,0,0,0,2020-03-10T20:00:00Z,0
2020-03-11,MS,0,20,0,0,0,20,2020-03-11T20:00:00Z,20
2020-03-12,MS,1,41,0,0,0,42,2020-03-12T20:00:00Z,42
2020-03-13,MS,4,41,0,0,0,45,2020-03-13T20:00:00Z,45
2020-03-14,MS,6,84,0,0,0,90,2020-03-14T20:00:00Z,90
2020-03-15,MS,10,84,0,0,0,94,2020-03-15T20:00:00Z,94
2020-03-16,MS,12,277,0,0,0,289,2020-03-16T20:00:00Z,289
2020-03-17,MS,21,368,0,0,0,389,2020-03-17T20:00:00Z,389
2020-03-18,MS,34,479,0,0,0,513,2020-03-18T20:00:00Z,513
2020-03-19,MS,50,552,0,0,0,602,2020-03-19T20:00:00Z,602
2020-03-20,MS,80,695,0,0,1,775,2020-03-20T20:00:00Z,775
2020-03-21,MS,140,695,0,0,1,835,2020-03-21T20:00:00Z,835
2020-03-22,MS,207,1114,0,33,1,1321,2020-03-22T20:00:00Z,1321
2020-03-23,MS,249,1143,0,33,1,1392,2020-03-23T20:00:00Z,1392
2020-03-24,MS,320,1552,0,86,1,1872,2020-03-24T20:00:00Z,1872
2020-03-07,MT,0,11,0,0,0,11,2020-03-07T21:00:00Z,11
2020-03-08,MT,0,11,0,0,0,11,2020-03-08T20:00:00Z,11
2020-03-09,MT,0,11,0,0,0,11,2020-03-09T20:00:00Z,11
2020-03-10,MT,0,15,0,0,0,15,2020-03-10T20:00:00Z,15
2020-03-11,MT,0,21,0,0,0,21,2020-03-11T20:00:00Z,21
2020-03-12,MT,1,34,0,0,0,35,2020-03-12T20:00:00Z,35
2020-03-13,MT,1,55,0,0,0,56,2020-03-13T20:00:00Z,56
2020-03-14,MT,5,103,0,0,0,108,2020-03-14T20:00:00Z,108
2020-03-15,MT,7,103,57,0,0,167,2020-03-15T20:00:00Z,110
2020-03-16,MT,7,198,0,0,0,205,2020-03-16T20:00:00Z,205
2020-03-17,MT,8,303,0,0,0,311,2020-03-17T20:00:00Z,311
2020-03-18,MT,10,499,0,0,0,509,2020-03-18T20:00:00Z,509
2020-03-19,MT,12,761,0,0,0,773,2020-03-19T20:00:00Z,773
2020-03-20,MT,16,931,0,0,0,947,2020-03-20T20:00:00Z,947
2020-03-21,MT,20,1146,0,0,0,1166,2020-03-21T20:00:00Z,1166
2020-03-22,MT,31,1146,0,0,0,1177,2020-03-22T20:00:00Z,1177
2020-03-23,MT,34,1146,0,0,0,1180,2020-03-23T20:00:00Z,1180
2020-03-24,MT,46,1643,0,0,0,1689,2020-03-24T20:00:00Z,1689
2020-03-04,NC,1,0,0,0,0,1,2020-03-04T21:00:00Z,1
2020-03-05,NC,1,0,0,0,0,1,2020-03-05T21:00:00Z,1
2020-03-06,NC,2,0,0,0,0,2,2020-03-06T21:00:00Z,2
2020-03-07,NC,2,0,0,0,0,2,2020-03-07T21:00:00Z,2
2020-03-08,NC,2,0,0,0,0,2,2020-03-08T20:00:00Z,2
2020-03-09,NC,2,0,0,0,0,2,2020-03-09T20:00:00Z,2
2020-03-10,NC,7,0,0,0,0,7,2020-03-10T20:00:00Z,7
2020-03-11,NC,7,0,0,0,0,7,2020-03-11T20:00:00Z,7
2020-03-12,NC,12,60,0,0,0,72,2020-03-12T20:00:00Z,72
2020-03-13,NC,15,86,0,0,0,101,2020-03-13T20:00:00Z,101
2020-03-14,NC,23,137,0,0,0,160,2020-03-14T20:00:00Z,160
2020-03-15,NC,32,227,151,0,0,410,2020-03-15T20:00:00Z,259
2020-03-16,NC,33,296,151,0,0,480,2020-03-16T20:00:00Z,329
2020-03-17,NC,40,474,0,0,0,514,2020-03-17T20:00:00Z,514
2020-03-18,NC,63,1787,0,0,0,1850,2020-03-18T20:00:00Z,1850
2020-03-19,NC,97,2408,0,0,0,2505,2020-03-19T20:00:00Z,2505
2020-03-20,NC,137,3096,0,0,0,3233,2020-03-20T20:00:00Z,3233
2020-03-21,NC,184,5092,0,0,0,5276,2020-03-21T20:00:00Z,5276
2020-03-22,NC,255,6183,0,0,0,6438,2020-03-22T20:00:00Z,6438
2020-03-23,NC,297,8141,0,0,0,8438,2020-03-23T20:00:00Z,8438
2020-03-24,NC,398,8141,0,0,0,8539,2020-03-24T20:00:00Z,8539
2020-03-07,ND,0,0,0,0,0,0,2020-03-07T21:00:00Z,0
2020-03-08,ND,0,0,0,0,0,0,2020-03-08T20:00:00Z,0
2020-03-09,ND,0,0,0,0,0,0,2020-03-09T20:00:00Z,0
2020-03-10,ND,0,6,2,0,0,8,2020-03-10T20:00:00Z,6
2020-03-11,ND,0,7,6,0,0,13,2020-03-11T20:00:00Z,7
2020-03-12,ND,1,12,14,0,0,27,2020-03-12T20:00:00Z,13
2020-03-13,ND,1,39,12,0,0,52,2020-03-13T20:00:00Z,40
2020-03-14,ND,1,54,14,0,0,69,2020-03-14T20:00:00Z,55
2020-03-15,ND,1,95,4,0,0,100,2020-03-15T20:00:00Z,96
2020-03-16,ND,1,123,0,0,0,124,2020-03-16T20:00:00Z,124
2020-03-17,ND,3,220,0,0,0,223,2020-03-17T20:00:00Z,223
2020-03-18,ND,6,268,0,0,0,274,2020-03-18T20:00:00Z,274
2020-03-19,ND,15,493,0,0,0,508,2020-03-19T20:00:00Z,508
2020-03-20,ND,20,800,0,0,0,820,2020-03-20T20:00:00Z,820
2020-03-21,ND,28,1141,0,3,0,1169,2020-03-21T20:00:00Z,1169
2020-03-22,ND,28,1260,0,3,0,1288,2020-03-22T20:00:00Z,1288
2020-03-23,ND,30,1353,0,4,0,1383,2020-03-23T20:00:00Z,1383
2020-03-24,ND,34,1454,0,5,0,1488,2020-03-24T20:00:00Z,1488
2020-03-05,NE,0,17,5,0,0,22,2020-03-05T21:00:00Z,17
2020-03-06,NE,0,17,5,0,0,22,2020-03-06T21:00:00Z,17
2020-03-07,NE,1,17,5,0,0,23,2020-03-07T21:00:00Z,18
2020-03-08,NE,1,17,5,0,0,23,2020-03-08T20:00:00Z,18
2020-03-09,NE,3,36,9,0,0,48,2020-03-09T20:00:00Z,39
2020-03-10,NE,3,47,16,0,0,66,2020-03-10T20:00:00Z,50
2020-03-11,NE,5,47,16,0,0,68,2020-03-11T20:00:00Z,52
2020-03-12,NE,10,80,33,0,0,123,2020-03-12T20:00:00Z,90
2020-03-13,NE,13,80,33,0,0,126,2020-03-13T20:00:00Z,93
2020-03-14,NE,14,80,33,0,0,127,2020-03-14T20:00:00Z,94
2020-03-15,NE,17,80,33,0,0,130,2020-03-15T20:00:00Z,97
2020-03-16,NE,18,170,0,0,0,188,2020-03-16T20:00:00Z,188
2020-03-17,NE,21,206,0,0,0,227,2020-03-17T20:00:00Z,227
2020-03-18,NE,24,206,0,0,0,230,2020-03-18T20:00:00Z,230
2020-03-19,NE,27,240,0,0,0,267,2020-03-19T20:00:00Z,267
2020-03-20,NE,32,240,0,0,0,272,2020-03-20T20:00:00Z,272
2020-03-21,NE,38,356,0,0,0,394,2020-03-21T20:00:00Z,394
2020-03-22,NE,48,356,0,0,0,404,2020-03-22T20:00:00Z,404
2020-03-23,NE,50,356,0,0,0,406,2020-03-23T20:00:00Z,406
2020-03-24,NE,52,975,0,0,0,1027,2020-03-24T20:00:00Z,1027
2020-03-04,NH,2,10,7,0,0,19,2020-03-04T21:00:00Z,12
2020-03-05,NH,2,16,4,0,0,22,2020-03-05T21:00:00Z,18
2020-03-06,NH,2,20,3,0,0,25,2020-03-06T21:00:00Z,22
2020-03-07,NH,2,20,3,0,0,25,2020-03-07T21:00:00Z,22
2020-03-08,NH,4,38,5,0,0,47,2020-03-08T20:00:00Z,42
2020-03-09,NH,4,38,5,0,0,47,2020-03-09T20:00:00Z,42
2020-03-10,NH,4,38,5,0,0,47,2020-03-10T20:00:00Z,42
2020-03-11,NH,4,38,5,0,0,47,2020-03-11T20:00:00Z,42
2020-03-12,NH,6,94,21,0,0,121,2020-03-12T20:00:00Z,100
2020-03-13,NH,6,94,21,0,0,121,2020-03-13T20:00:00Z,100
2020-03-14,NH,7,212,31,0,0,250,2020-03-14T20:00:00Z,219
2020-03-15,NH,13,271,95,0,0,379,2020-03-15T20:00:00Z,284
2020-03-16,NH,13,271,95,0,0,379,2020-03-16T20:00:00Z,284
2020-03-17,NH,17,355,195,0,0,567,2020-03-17T20:00:00Z,372
2020-03-18,NH,26,513,208,0,0,747,2020-03-18T20:00:00Z,539
2020-03-19,NH,39,621,231,0,0,891,2020-03-19T20:00:00Z,660
2020-03-20,NH,44,745,631,0,0,1420,2020-03-20T20:00:00Z,789
2020-03-21,NH,55,973,942,0,0,1970,2020-03-21T20:00:00Z,1028
2020-03-22,NH,65,1188,959,0,0,2212,2020-03-22T20:00:00Z,1253
2020-03-23,NH,78,1374,889,0,0,2341,2020-03-23T20:00:00Z,1452
2020-03-24,NH,101,1447,869,11,1,2417,2020-03-24T20:00:00Z,1548
2020-03-05,NJ,1,0,0,0,0,1,2020-03-05T21:00:00Z,1
2020-03-06,NJ,1,0,0,0,0,1,2020-03-06T21:00:00Z,1
2020-03-07,NJ,4,0,1,0,0,5,2020-03-07T21:00:00Z,4
2020-03-08,NJ,6,31,0,0,0,37,2020-03-08T20:00:00Z,37
2020-03-09,NJ,11,35,14,0,0,60,2020-03-09T20:00:00Z,46
2020-03-10,NJ,15,44,20,0,0,79,2020-03-10T20:00:00Z,59
2020-03-11,NJ,24,57,20,0,1,100,2020-03-11T20:00:00Z,81
2020-03-12,NJ,30,74,20,0,1,124,2020-03-12T20:00:00Z,104
2020-03-13,NJ,50,97,80,0,1,227,2020-03-13T20:00:00Z,147
2020-03-14,NJ,50,97,80,0,1,227,2020-03-14T20:00:00Z,147
2020-03-15,NJ,98,120,34,0,2,252,2020-03-15T20:00:00Z,218
2020-03-16,NJ,178,120,20,0,2,218,2020-03-16T20:00:00Z,298
2020-03-17,NJ,267,163,55,0,3,485,2020-03-17T20:00:00Z,430
2020-03-18,NJ,427,190,21,0,5,638,2020-03-18T20:00:00Z,617
2020-03-19,NJ,742,210,74,0,9,1026,2020-03-19T20:00:00Z,952
2020-03-20,NJ,890,264,86,0,11,1240,2020-03-20T20:00:00Z,1154
2020-03-21,NJ,1327,294,40,0,16,1661,2020-03-21T20:00:00Z,1621
2020-03-22,NJ,1914,327,49,0,20,2290,2020-03-22T20:00:00Z,2241
2020-03-23,NJ,2844,359,94,0,27,3297,2020-03-23T20:00:00Z,3203
2020-03-24,NJ,3675,8325,45,0,44,12045,2020-03-24T20:00:00Z,12000
2020-03-06,NM,0,16,0,0,0,16,2020-03-06T21:00:00Z,16
2020-03-07,NM,0,48,0,0,0,48,2020-03-07T21:00:00Z,48
2020-03-08,NM,0,48,0,0,0,48,2020-03-08T20:00:00Z,48
2020-03-09,NM,0,57,0,0,0,57,2020-03-09T20:00:00Z,57
2020-03-10,NM,0,69,0,0,0,69,2020-03-10T20:00:00Z,69
2020-03-11,NM,3,87,0,0,0,90,2020-03-11T20:00:00Z,90
2020-03-12,NM,5,155,0,0,0,160,2020-03-12T20:00:00Z,160
2020-03-13,NM,10,190,0,0,0,200,2020-03-13T20:00:00Z,200
2020-03-14,NM,10,237,0,0,0,247,2020-03-14T20:00:00Z,247
2020-03-15,NM,13,482,0,0,0,495,2020-03-15T20:00:00Z,495
2020-03-16,NM,17,566,0,0,0,583,2020-03-16T20:00:00Z,583
2020-03-17,NM,23,1249,0,0,0,1272,2020-03-17T20:00:00Z,1272
2020-03-18,NM,28,2326,0,0,0,2354,2020-03-18T20:00:00Z,2354
2020-03-19,NM,35,2762,0,0,0,2797,2020-03-19T20:00:00Z,2797
2020-03-20,NM,43,3771,0,0,0,3814,2020-03-20T20:00:00Z,3814
2020-03-21,NM,57,3771,0,0,0,3828,2020-03-21T20:00:00Z,3828
2020-03-22,NM,57,4722,0,0,0,4779,2020-03-22T20:00:00Z,4779
2020-03-23,NM,65,5321,0,0,0,5386,2020-03-23T20:00:00Z,5386
2020-03-24,NM,83,5890,0,0,0,5973,2020-03-24T20:00:00Z,5973
2020-03-05,NV,1,14,0,0,0,15,2020-03-05T21:00:00Z,15
2020-03-06,NV,1,14,0,0,0,15,2020-03-06T21:00:00Z,15
2020-03-07,NV,1,14,0,0,0,15,2020-03-07T21:00:00Z,15
2020-03-08,NV,1,14,0,0,0,15,2020-03-08T20:00:00Z,15
2020-03-09,NV,1,14,0,0,0,15,2020-03-09T20:00:00Z,15
2020-03-10,NV,0,14,0,0,0,14,2020-03-10T20:00:00Z,14
2020-03-11,NV,5,168,0,0,0,173,2020-03-11T20:00:00Z,173
2020-03-12,NV,7,168,0,0,0,175,2020-03-12T20:00:00Z,175
2020-03-13,NV,11,168,0,0,0,179,2020-03-13T20:00:00Z,179
2020-03-14,NV,20,168,0,0,0,188,2020-03-14T20:00:00Z,188
2020-03-15,NV,21,168,164,0,0,353,2020-03-15T20:00:00Z,189
2020-03-16,NV,45,168,0,0,1,213,2020-03-16T20:00:00Z,213
2020-03-17,NV,55,168,0,0,1,223,2020-03-17T20:00:00Z,223
2020-03-18,NV,55,168,0,0,1,223,2020-03-18T20:00:00Z,223
2020-03-19,NV,95,1626,0,0,1,1721,2020-03-19T20:00:00Z,1721
2020-03-20,NV,109,1992,-3,0,1,2098,2020-03-20T20:00:00Z,2101
2020-03-21,NV,124,2384,0,0,2,2508,2020-03-21T20:00:00Z,2508
2020-03-22,NV,190,2448,0,0,2,2638,2020-03-22T20:00:00Z,2638
2020-03-23,NV,245,3490,0,0,4,3735,2020-03-23T20:00:00Z,3735
2020-03-24,NV,278,3954,0,0,4,4232,2020-03-24T20:00:00Z,4232
2020-03-04,NY,6,48,24,0,0,78,2020-03-04T21:00:00Z,54
2020-03-05,NY,22,76,24,0,0,122,2020-03-05T21:00:00Z,98
2020-03-06,NY,33,92,236,0,0,361,2020-03-06T21:00:00Z,125
2020-03-07,NY,76,92,236,0,0,404,2020-03-07T21:00:00Z,168
2020-03-08,NY,105,92,0,0,0,197,2020-03-08T20:00:00Z,197
2020-03-09,NY,142,92,0,0,0,234,2020-03-09T20:00:00Z,234
2020-03-10,NY,173,92,0,0,0,265,2020-03-10T20:00:00Z,265
2020-03-11,NY,216,92,0,0,0,308,2020-03-11T20:00:00Z,308
2020-03-12,NY,216,92,0,0,0,308,2020-03-12T20:00:00Z,308
2020-03-13,NY,421,2779,0,0,0,3200,2020-03-13T20:00:00Z,3200
2020-03-14,NY,524,2779,0,0,0,3303,2020-03-14T20:00:00Z,3303
2020-03-15,NY,729,4543,0,0,3,5272,2020-03-15T20:00:00Z,5272
2020-03-16,NY,950,4543,0,0,7,5493,2020-03-16T20:00:00Z,5493
2020-03-17,NY,1700,5506,0,0,7,7206,2020-03-17T20:00:00Z,7206
2020-03-18,NY,2382,12215,0,0,12,14597,2020-03-18T20:00:00Z,14597
2020-03-19,NY,4152,18132,0,0,12,22284,2020-03-19T20:00:00Z,22284
2020-03-20,NY,7102,25325,0,0,35,32427,2020-03-20T20:00:00Z,32427
2020-03-21,NY,10356,35081,0,1603,44,45437,2020-03-21T20:00:00Z,45437
2020-03-22,NY,15168,46233,0,1974,114,61401,2020-03-22T20:00:00Z,61401
2020-03-23,NY,20875,57414,0,2635,114,78289,2020-03-23T20:00:00Z,78289
2020-03-24,NY,25665,65605,0,3234,210,91270,2020-03-24T20:00:00Z,91270
2020-03-05,OH,0,7,3,0,0,10,2020-03-05T21:00:00Z,7
2020-03-06,OH,0,8,2,0,0,10,2020-03-06T21:00:00Z,8
2020-03-07,OH,0,9,5,0,0,14,2020-03-07T21:00:00Z,9
2020-03-08,OH,0,10,4,0,0,14,2020-03-08T20:00:00Z,10
2020-03-09,OH,3,11,5,0,0,19,2020-03-09T20:00:00Z,14
2020-03-10,OH,3,14,15,0,0,32,2020-03-10T20:00:00Z,17
2020-03-11,OH,4,21,24,0,0,49,2020-03-11T20:00:00Z,25
2020-03-12,OH,5,30,52,0,0,87,2020-03-12T20:00:00Z,35
2020-03-13,OH,13,50,159,0,0,222,2020-03-13T20:00:00Z,63
2020-03-14,OH,13,50,159,0,0,222,2020-03-14T20:00:00Z,63
2020-03-15,OH,36,139,350,0,0,525,2020-03-15T20:00:00Z,175
2020-03-16,OH,50,140,361,0,0,551,2020-03-16T20:00:00Z,190
2020-03-17,OH,67,140,0,0,0,207,2020-03-17T20:00:00Z,207
2020-03-18,OH,88,140,0,0,0,228,2020-03-18T20:00:00Z,228
2020-03-19,OH,119,140,0,0,0,259,2020-03-19T20:00:00Z,259
2020-03-20,OH,169,140,0,0,1,309,2020-03-20T20:00:00Z,309
2020-03-21,OH,247,140,0,58,3,387,2020-03-21T20:00:00Z,387
2020-03-22,OH,351,140,0,83,3,491,2020-03-22T20:00:00Z,491
2020-03-23,OH,442,140,0,104,6,582,2020-03-23T20:00:00Z,582
2020-03-24,OH,564,140,0,145,8,704,2020-03-24T20:00:00Z,704
2020-03-07,OK,1,0,0,0,0,1,2020-03-07T21:00:00Z,1
2020-03-08,OK,1,8,2,0,0,11,2020-03-08T20:00:00Z,9
2020-03-09,OK,1,8,10,0,0,19,2020-03-09T20:00:00Z,9
2020-03-10,OK,2,15,11,0,0,28,2020-03-10T20:00:00Z,17
2020-03-11,OK,2,15,11,0,0,28,2020-03-11T20:00:00Z,17
2020-03-12,OK,3,36,4,0,0,43,2020-03-12T20:00:00Z,39
2020-03-13,OK,3,36,37,0,0,76,2020-03-13T20:00:00Z,39
2020-03-14,OK,4,36,37,0,0,77,2020-03-14T20:00:00Z,40
2020-03-15,OK,9,118,12,0,0,139,2020-03-15T20:00:00Z,127
2020-03-16,OK,10,174,29,0,0,213,2020-03-16T20:00:00Z,184
2020-03-17,OK,17,247,82,0,0,346,2020-03-17T20:00:00Z,264
2020-03-18,OK,29,378,110,0,0,517,2020-03-18T20:00:00Z,407
2020-03-19,OK,44,466,250,0,1,760,2020-03-19T20:00:00Z,510
2020-03-20,OK,49,538,374,0,1,961,2020-03-20T20:00:00Z,587
2020-03-21,OK,53,560,144,10,1,757,2020-03-21T20:00:00Z,613
2020-03-22,OK,67,669,102,11,2,838,2020-03-22T20:00:00Z,736
2020-03-23,OK,81,694,102,15,2,877,2020-03-23T20:00:00Z,775
2020-03-24,OK,106,735,0,25,3,841,2020-03-24T20:00:00Z,841
2020-03-04,OR,3,29,18,0,0,50,2020-03-04T21:00:00Z,32
2020-03-05,OR,3,45,13,0,0,61,2020-03-05T21:00:00Z,48
2020-03-06,OR,3,64,28,0,0,95,2020-03-06T21:00:00Z,67
2020-03-07,OR,7,77,40,0,0,124,2020-03-07T21:00:00Z,84
2020-03-08,OR,14,100,53,0,0,167,2020-03-08T20:00:00Z,114
2020-03-09,OR,14,165,52,0,0,231,2020-03-09T20:00:00Z,179
2020-03-10,OR,15,213,67,0,0,295,2020-03-10T20:00:00Z,228
2020-03-11,OR,19,286,62,0,0,367,2020-03-11T20:00:00Z,305
2020-03-12,OR,19,286,62,0,0,367,2020-03-12T20:00:00Z,305
2020-03-13,OR,30,337,157,0,0,524,2020-03-13T20:00:00Z,367
2020-03-14,OR,30,337,157,0,0,524,2020-03-14T20:00:00Z,367
2020-03-15,OR,36,420,225,0,0,681,2020-03-15T20:00:00Z,456
2020-03-16,OR,39,579,182,0,0,800,2020-03-16T20:00:00Z,618
2020-03-17,OR,47,689,184,0,0,920,2020-03-17T20:00:00Z,736
2020-03-18,OR,75,1118,361,0,3,1554,2020-03-18T20:00:00Z,1193
2020-03-19,OR,88,1329,437,0,3,1854,2020-03-19T20:00:00Z,1417
2020-03-20,OR,114,2003,433,0,3,2550,2020-03-20T20:00:00Z,2117
2020-03-21,OR,114,2003,433,0,3,2550,2020-03-21T20:00:00Z,2117
2020-03-22,OR,161,2864,0,43,4,3025,2020-03-22T20:00:00Z,3025
2020-03-23,OR,191,3649,0,56,5,3840,2020-03-23T20:00:00Z,3840
2020-03-24,OR,209,4350,0,61,8,4559,2020-03-24T20:00:00Z,4559
2020-03-06,PA,2,0,0,0,0,2,2020-03-06T21:00:00Z,2
2020-03-07,PA,2,0,0,0,0,2,2020-03-07T21:00:00Z,2
2020-03-08,PA,4,0,0,0,0,4,2020-03-08T20:00:00Z,4
2020-03-09,PA,7,0,0,0,0,7,2020-03-09T20:00:00Z,7
2020-03-10,PA,12,0,0,0,0,12,2020-03-10T20:00:00Z,12
2020-03-11,PA,15,88,54,0,0,157,2020-03-11T20:00:00Z,103
2020-03-12,PA,22,116,81,0,0,219,2020-03-12T20:00:00Z,138
2020-03-13,PA,33,140,130,0,0,303,2020-03-13T20:00:00Z,173
2020-03-14,PA,47,205,150,0,0,402,2020-03-14T20:00:00Z,252
2020-03-15,PA,63,205,183,0,0,451,2020-03-15T20:00:00Z,268
2020-03-16,PA,76,670,0,0,0,746,2020-03-16T20:00:00Z,746
2020-03-17,PA,96,879,0,0,0,975,2020-03-17T20:00:00Z,975
2020-03-18,PA,133,1187,0,0,0,1320,2020-03-18T20:00:00Z,1320
2020-03-19,PA,185,1608,0,0,1,1793,2020-03-19T20:00:00Z,1793
2020-03-20,PA,268,2574,0,0,1,2842,2020-03-20T20:00:00Z,2842
2020-03-21,PA,371,3766,0,0,2,4137,2020-03-21T20:00:00Z,4137
2020-03-22,PA,479,4964,0,0,2,5443,2020-03-22T20:00:00Z,5443
2020-03-23,PA,644,6595,0,0,6,7239,2020-03-23T20:00:00Z,7239
2020-03-24,PA,851,8643,0,0,7,9494,2020-03-24T20:00:00Z,9494
2020-03-16,PR,5,9,0,0,0,14,2020-03-16T20:00:00Z,14
2020-03-17,PR,5,13,4,0,0,22,2020-03-17T20:00:00Z,18
2020-03-18,PR,5,31,21,0,0,57,2020-03-18T20:00:00Z,36
2020-03-19,PR,5,56,29,0,0,90,2020-03-19T20:00:00Z,61
2020-03-20,PR,14,114,52,0,0,180,2020-03-20T20:00:00Z,128
2020-03-21,PR,21,143,71,0,0,235,2020-03-21T20:00:00Z,164
2020-03-22,PR,23,183,69,0,0,275,2020-03-22T20:00:00Z,206
2020-03-23,PR,31,189,35,0,2,255,2020-03-23T20:00:00Z,220
2020-03-24,PR,39,268,42,0,2,349,2020-03-24T20:00:00Z,307
2020-03-07,RI,2,0,0,0,0,2,2020-03-07T21:00:00Z,2
2020-03-08,RI,3,30,12,0,0,45,2020-03-08T20:00:00Z,33
2020-03-09,RI,3,53,6,0,0,62,2020-03-09T20:00:00Z,56
2020-03-10,RI,3,53,6,0,0,62,2020-03-10T20:00:00Z,56
2020-03-11,RI,5,58,24,0,0,87,2020-03-11T20:00:00Z,63
2020-03-12,RI,5,94,8,0,0,107,2020-03-12T20:00:00Z,99
2020-03-13,RI,14,142,29,0,0,185,2020-03-13T20:00:00Z,156
2020-03-14,RI,20,198,57,0,0,275,2020-03-14T20:00:00Z,218
2020-03-15,RI,20,198,57,0,0,275,2020-03-15T20:00:00Z,218
2020-03-16,RI,21,308,149,0,0,478,2020-03-16T20:00:00Z,329
2020-03-17,RI,21,308,149,0,0,478,2020-03-17T20:00:00Z,329
2020-03-18,RI,33,540,334,0,0,907,2020-03-18T20:00:00Z,573
2020-03-19,RI,33,540,334,0,0,907,2020-03-19T20:00:00Z,573
2020-03-20,RI,54,654,140,0,0,848,2020-03-20T20:00:00Z,708
2020-03-21,RI,66,862,290,0,0,1218,2020-03-21T20:00:00Z,928
2020-03-22,RI,83,932,216,0,0,1231,2020-03-22T20:00:00Z,1015
2020-03-23,RI,106,932,216,0,0,1254,2020-03-23T20:00:00Z,1038
2020-03-24,RI,106,1120,77,0,0,1303,2020-03-24T20:00:00Z,1226
2020-03-04,SC,0,5,0,0,0,5,2020-03-04T21:00:00Z,5
2020-03-05,SC,0,5,0,0,0,5,2020-03-05T21:00:00Z,5
2020-03-06,SC,0,5,0,0,0,5,2020-03-06T21:00:00Z,5
2020-03-07,SC,2,8,0,0,0,10,2020-03-07T21:00:00Z,10
2020-03-08,SC,2,8,0,0,0,10,2020-03-08T20:00:00Z,10
2020-03-09,SC,7,24,0,0,0,31,2020-03-09T20:00:00Z,31
2020-03-10,SC,7,24,0,0,0,31,2020-03-10T20:00:00Z,31
2020-03-11,SC,9,32,0,0,0,41,2020-03-11T20:00:00Z,41
2020-03-12,SC,10,48,0,0,0,58,2020-03-12T20:00:00Z,58
2020-03-13,SC,12,75,0,0,0,87,2020-03-13T20:00:00Z,87
2020-03-14,SC,13,110,0,0,0,123,2020-03-14T20:00:00Z,123
2020-03-15,SC,19,154,0,0,0,173,2020-03-15T20:00:00Z,173
2020-03-16,SC,28,235,0,0,1,263,2020-03-16T20:00:00Z,263
2020-03-17,SC,33,311,0,0,1,344,2020-03-17T20:00:00Z,344
2020-03-18,SC,60,583,0,0,1,643,2020-03-18T20:00:00Z,643
2020-03-19,SC,60,583,0,0,1,643,2020-03-19T20:00:00Z,643
2020-03-20,SC,81,833,0,0,1,914,2020-03-20T20:00:00Z,914
2020-03-21,SC,152,1255,0,0,1,1407,2020-03-21T20:00:00Z,1407
2020-03-22,SC,195,1466,0,0,3,1661,2020-03-22T20:00:00Z,1661
2020-03-23,SC,299,1466,0,0,5,1765,2020-03-23T20:00:00Z,1765
2020-03-24,SC,298,2012,0,0,5,2310,2020-03-24T20:00:00Z,2310
2020-03-07,SD,0,5,0,0,0,5,2020-03-07T21:00:00Z,5
2020-03-08,SD,0,5,0,0,0,5,2020-03-08T20:00:00Z,5
2020-03-09,SD,0,5,0,0,0,5,2020-03-09T20:00:00Z,5
2020-03-10,SD,0,11,0,0,0,11,2020-03-10T20:00:00Z,11
2020-03-11,SD,5,13,2,0,0,20,2020-03-11T20:00:00Z,18
2020-03-12,SD,8,27,11,0,0,46,2020-03-12T20:00:00Z,35
2020-03-13,SD,9,73,11,0,0,93,2020-03-13T20:00:00Z,82
2020-03-14,SD,9,182,3,0,0,194,2020-03-14T20:00:00Z,191
2020-03-15,SD,9,327,6,0,0,342,2020-03-15T20:00:00Z,336
2020-03-16,SD,10,494,0,0,0,504,2020-03-16T20:00:00Z,504
2020-03-17,SD,11,551,35,0,0,597,2020-03-17T20:00:00Z,562
2020-03-18,SD,11,551,350,0,1,913,2020-03-18T20:00:00Z,562
2020-03-19,SD,11,551,385,0,1,947,2020-03-19T20:00:00Z,562
2020-03-20,SD,14,663,270,0,1,947,2020-03-20T20:00:00Z,677
2020-03-21,SD,14,691,268,0,1,973,2020-03-21T20:00:00Z,705
2020-03-22,SD,21,740,277,0,1,1038,2020-03-22T20:00:00Z,761
2020-03-23,SD,28,762,265,0,1,1055,2020-03-23T20:00:00Z,790
2020-03-24,SD,30,790,268,0,1,1088,2020-03-24T20:00:00Z,820
2020-03-05,TN,1,0,0,0,0,1,2020-03-05T21:00:00Z,1
2020-03-06,TN,1,0,0,0,0,1,2020-03-06T21:00:00Z,1
2020-03-07,TN,1,0,0,0,0,1,2020-03-07T21:00:00Z,1
2020-03-08,TN,3,0,0,0,0,3,2020-03-08T20:00:00Z,3
2020-03-09,TN,3,0,0,0,0,3,2020-03-09T20:00:00Z,3
2020-03-10,TN,7,0,0,0,0,7,2020-03-10T20:00:00Z,7
2020-03-11,TN,7,50,0,0,0,57,2020-03-11T20:00:00Z,57
2020-03-12,TN,18,79,0,0,0,97,2020-03-12T20:00:00Z,97
2020-03-13,TN,26,116,0,0,0,142,2020-03-13T20:00:00Z,142
2020-03-14,TN,32,130,0,0,0,162,2020-03-14T20:00:00Z,162
2020-03-15,TN,39,157,0,0,0,196,2020-03-15T20:00:00Z,196
2020-03-16,TN,52,270,0,0,0,322,2020-03-16T20:00:00Z,322
2020-03-17,TN,73,330,0,0,0,403,2020-03-17T20:00:00Z,403
2020-03-18,TN,98,349,0,0,0,447,2020-03-18T20:00:00Z,447
2020-03-19,TN,154,349,0,0,0,503,2020-03-19T20:00:00Z,503
2020-03-20,TN,228,563,0,0,0,791,2020-03-20T20:00:00Z,791
2020-03-21,TN,371,3272,0,0,0,3643,2020-03-21T20:00:00Z,3643
2020-03-22,TN,505,3272,0,0,0,3777,2020-03-22T20:00:00Z,3777
2020-03-23,TN,615,3272,0,0,2,3887,2020-03-23T20:00:00Z,3887
2020-03-24,TN,667,10517,0,0,2,11184,2020-03-24T20:00:00Z,11184
2020-03-04,TX,1,0,0,0,0,1,2020-03-04T21:00:00Z,1
2020-03-05,TX,1,0,0,0,0,1,2020-03-05T21:00:00Z,1
2020-03-06,TX,5,0,0,0,0,5,2020-03-06T21:00:00Z,5
2020-03-07,TX,8,0,0,0,0,8,2020-03-07T21:00:00Z,8
2020-03-08,TX,8,0,0,0,0,8,2020-03-08T20:00:00Z,8
2020-03-09,TX,12,0,0,0,0,12,2020-03-09T20:00:00Z,12
2020-03-10,TX,13,0,0,0,0,13,2020-03-10T20:00:00Z,13
2020-03-11,TX,21,0,0,0,0,21,2020-03-11T20:00:00Z,21
2020-03-12,TX,23,0,0,0,0,23,2020-03-12T20:00:00Z,23
2020-03-13,TX,39,0,0,0,0,39,2020-03-13T20:00:00Z,39
2020-03-14,TX,51,0,0,0,0,51,2020-03-14T20:00:00Z,51
2020-03-15,TX,56,0,0,0,0,56,2020-03-15T20:00:00Z,56
2020-03-16,TX,57,0,0,0,0,57,2020-03-16T20:00:00Z,57
2020-03-17,TX,64,1204,0,0,1,1268,2020-03-17T20:00:00Z,1268
2020-03-18,TX,83,1824,0,0,2,1907,2020-03-18T20:00:00Z,1907
2020-03-19,TX,143,2212,0,0,3,2355,2020-03-19T20:00:00Z,2355
2020-03-20,TX,194,5083,0,0,5,5277,2020-03-20T20:00:00Z,5277
2020-03-21,TX,304,6218,0,0,5,6522,2020-03-21T20:00:00Z,6522
2020-03-22,TX,334,8422,0,0,5,8756,2020-03-22T20:00:00Z,8756
2020-03-23,TX,352,9703,0,0,8,10055,2020-03-23T20:00:00Z,10055
2020-03-24,TX,410,10757,0,0,9,11167,2020-03-24T20:00:00Z,11167
2020-03-07,UT,1,0,0,0,0,1,2020-03-07T21:00:00Z,1
2020-03-08,UT,1,0,0,0,0,1,2020-03-08T20:00:00Z,1
2020-03-09,UT,1,0,0,0,0,1,2020-03-09T20:00:00Z,1
2020-03-10,UT,2,0,0,0,0,2,2020-03-10T20:00:00Z,2
2020-03-11,UT,2,0,0,0,0,2,2020-03-11T20:00:00Z,2
2020-03-12,UT,4,131,0,0,0,135,2020-03-12T20:00:00Z,135
2020-03-13,UT,6,131,0,0,0,137,2020-03-13T20:00:00Z,137
2020-03-14,UT,6,131,0,0,0,137,2020-03-14T20:00:00Z,137
2020-03-15,UT,28,131,0,0,0,159,2020-03-15T20:00:00Z,159
2020-03-16,UT,39,131,0,0,0,170,2020-03-16T20:00:00Z,170
2020-03-17,UT,51,131,0,0,0,182,2020-03-17T20:00:00Z,182
2020-03-18,UT,63,131,0,0,0,194,2020-03-18T20:00:00Z,194
2020-03-19,UT,78,1448,0,0,0,1526,2020-03-19T20:00:00Z,1526
2020-03-20,UT,112,2035,0,0,0,2147,2020-03-20T20:00:00Z,2147
2020-03-21,UT,136,2424,0,0,0,2560,2020-03-21T20:00:00Z,2560
2020-03-22,UT,181,3508,0,0,1,3689,2020-03-22T20:00:00Z,3689
2020-03-23,UT,257,4790,0,0,1,5047,2020-03-23T20:00:00Z,5047
2020-03-24,UT,299,5524,0,0,1,5823,2020-03-24T20:00:00Z,5823
2020-03-05,VA,0,18,3,0,0,21,2020-03-05T21:00:00Z,18
2020-03-06,VA,0,21,10,0,0,31,2020-03-06T21:00:00Z,21
2020-03-07,VA,0,31,7,0,0,38,2020-03-07T21:00:00Z,31
2020-03-08,VA,2,36,6,0,0,44,2020-03-08T20:00:00Z,38
2020-03-09,VA,3,38,9,0,0,50,2020-03-09T20:00:00Z,41
2020-03-10,VA,8,53,0,0,0,61,2020-03-10T20:00:00Z,61
2020-03-11,VA,9,60,0,0,0,69,2020-03-11T20:00:00Z,69
2020-03-12,VA,17,117,0,0,0,134,2020-03-12T20:00:00Z,134
2020-03-13,VA,30,117,0,0,0,147,2020-03-13T20:00:00Z,147
2020-03-14,VA,30,117,0,0,0,147,2020-03-14T20:00:00Z,147
2020-03-15,VA,45,363,0,0,1,408,2020-03-15T20:00:00Z,408
2020-03-16,VA,51,438,0,0,1,489,2020-03-16T20:00:00Z,489
2020-03-17,VA,67,961,0,0,1,1028,2020-03-17T20:00:00Z,1028
2020-03-18,VA,77,1201,0,0,1,1278,2020-03-18T20:00:00Z,1278
2020-03-19,VA,94,1829,0,0,2,1923,2020-03-19T20:00:00Z,1923
2020-03-20,VA,114,2211,0,0,2,2325,2020-03-20T20:00:00Z,2325
2020-03-21,VA,152,2638,0,25,2,2790,2020-03-21T20:00:00Z,2790
2020-03-22,VA,219,3118,0,32,3,3337,2020-03-22T20:00:00Z,3337
2020-03-23,VA,254,3443,0,38,6,3697,2020-03-23T20:00:00Z,3697
2020-03-24,VA,290,4180,0,45,7,4470,2020-03-24T20:00:00Z,4470
2020-03-16,VI,1,0,0,0,0,1,2020-03-16T20:00:00Z,1
2020-03-17,VI,2,0,0,0,0,2,2020-03-17T20:00:00Z,2
2020-03-18,VI,2,0,0,0,0,2,2020-03-18T20:00:00Z,2
2020-03-19,VI,3,0,0,0,0,3,2020-03-19T20:00:00Z,3
2020-03-20,VI,3,0,0,0,0,3,2020-03-20T20:00:00Z,3
2020-03-21,VI,6,0,0,0,0,6,2020-03-21T20:00:00Z,6
2020-03-22,VI,6,0,0,0,0,6,2020-03-22T20:00:00Z,6
2020-03-23,VI,17,0,0,0,0,17,2020-03-23T20:00:00Z,17
2020-03-24,VI,17,0,0,0,0,17,2020-03-24T20:00:00Z,17
2020-03-06,VT,0,8,0,0,0,8,2020-03-06T21:00:00Z,8
2020-03-07,VT,0,16,0,0,0,16,2020-03-07T21:00:00Z,16
2020-03-08,VT,1,28,0,0,0,29,2020-03-08T20:00:00Z,29
2020-03-09,VT,1,34,0,0,0,35,2020-03-09T20:00:00Z,35
2020-03-10,VT,1,40,0,0,0,41,2020-03-10T20:00:00Z,41
2020-03-11,VT,1,62,0,0,0,63,2020-03-11T20:00:00Z,63
2020-03-12,VT,2,97,0,0,0,99,2020-03-12T20:00:00Z,99
2020-03-13,VT,2,142,0,0,0,144,2020-03-13T20:00:00Z,144
2020-03-14,VT,4,227,0,0,0,231,2020-03-14T20:00:00Z,231
2020-03-15,VT,4,348,0,0,0,352,2020-03-15T20:00:00Z,352
2020-03-16,VT,8,421,0,0,0,429,2020-03-16T20:00:00Z,429
2020-03-17,VT,10,495,0,0,0,505,2020-03-17T20:00:00Z,505
2020-03-18,VT,19,592,0,0,0,611,2020-03-18T20:00:00Z,611
2020-03-19,VT,22,645,0,0,0,667,2020-03-19T20:00:00Z,667
2020-03-20,VT,29,779,0,0,2,808,2020-03-20T20:00:00Z,808
2020-03-21,VT,29,779,0,0,2,808,2020-03-21T20:00:00Z,808
2020-03-22,VT,52,1106,0,0,2,1158,2020-03-22T20:00:00Z,1158
2020-03-23,VT,75,1106,0,0,5,1181,2020-03-23T20:00:00Z,1181
2020-03-24,VT,95,1440,0,0,7,1535,2020-03-24T20:00:00Z,1535
2020-03-04,WA,39,0,0,0,0,39,2020-03-04T21:00:00Z,39
2020-03-05,WA,70,0,0,0,0,70,2020-03-05T21:00:00Z,70
2020-03-06,WA,79,370,0,0,0,449,2020-03-06T21:00:00Z,449
2020-03-07,WA,102,370,66,0,0,538,2020-03-07T21:00:00Z,472
2020-03-08,WA,102,640,60,0,0,802,2020-03-08T20:00:00Z,742
2020-03-09,WA,136,1110,0,0,0,1246,2020-03-09T20:00:00Z,1246
2020-03-10,WA,162,1110,0,0,0,1272,2020-03-10T20:00:00Z,1272
2020-03-11,WA,267,2175,0,0,24,2466,2020-03-11T20:00:00Z,2442
2020-03-12,WA,337,3037,0,0,29,3403,2020-03-12T20:00:00Z,3374
2020-03-13,WA,457,4350,0,0,31,4807,2020-03-13T20:00:00Z,4807
2020-03-14,WA,568,6001,0,0,37,6569,2020-03-14T20:00:00Z,6569
2020-03-15,WA,642,7122,0,0,40,7764,2020-03-15T20:00:00Z,7764
2020-03-16,WA,769,9451,0,0,42,10220,2020-03-16T20:00:00Z,10220
2020-03-17,WA,904,11582,0,0,48,12486,2020-03-17T20:00:00Z,12486
2020-03-18,WA,1012,13117,0,0,52,14129,2020-03-18T20:00:00Z,14129
2020-03-19,WA,1187,15918,0,0,66,17105,2020-03-19T20:00:00Z,17105
2020-03-20,WA,1376,19336,0,0,74,20712,2020-03-20T20:00:00Z,20712
2020-03-21,WA,1524,21719,0,0,83,23243,2020-03-21T20:00:00Z,23243
2020-03-22,WA,1793,25328,0,0,94,27121,2020-03-22T20:00:00Z,27121
2020-03-23,WA,1996,28879,0,0,95,30875,2020-03-23T20:00:00Z,30875
2020-03-24,WA,2221,31712,0,0,110,33933,2020-03-24T20:00:00Z,33933
2020-03-04,WI,1,19,6,0,0,26,2020-03-04T21:00:00Z,20
2020-03-05,WI,1,19,6,0,0,26,2020-03-05T21:00:00Z,20
2020-03-06,WI,1,31,12,0,0,44,2020-03-06T21:00:00Z,32
2020-03-07,WI,1,31,12,0,0,44,2020-03-07T21:00:00Z,32
2020-03-08,WI,1,31,12,0,0,44,2020-03-08T20:00:00Z,32
2020-03-09,WI,1,36,0,0,0,37,2020-03-09T20:00:00Z,37
2020-03-10,WI,2,36,0,0,0,38,2020-03-10T20:00:00Z,38
2020-03-11,WI,3,43,0,0,0,46,2020-03-11T20:00:00Z,46
2020-03-12,WI,8,84,0,0,0,92,2020-03-12T20:00:00Z,92
2020-03-13,WI,19,169,0,0,0,188,2020-03-13T20:00:00Z,188
2020-03-14,WI,19,169,0,0,0,188,2020-03-14T20:00:00Z,188
2020-03-15,WI,33,313,0,0,0,346,2020-03-15T20:00:00Z,346
2020-03-16,WI,47,504,0,0,0,551,2020-03-16T20:00:00Z,551
2020-03-17,WI,72,1038,0,0,0,1110,2020-03-17T20:00:00Z,1110
2020-03-18,WI,106,1577,0,0,0,1683,2020-03-18T20:00:00Z,1683
2020-03-19,WI,155,2192,0,0,0,2347,2020-03-19T20:00:00Z,2347
2020-03-20,WI,206,3455,0,0,3,3661,2020-03-20T20:00:00Z,3661
2020-03-21,WI,281,4628,0,0,4,4909,2020-03-21T20:00:00Z,4909
2020-03-22,WI,385,6230,0,0,4,6615,2020-03-22T20:00:00Z,6615
2020-03-23,WI,416,7050,0,0,5,7466,2020-03-23T20:00:00Z,7466
2020-03-24,WI,457,8237,0,0,5,8694,2020-03-24T20:00:00Z,8694
2020-03-06,WV,0,1,4,0,0,5,2020-03-06T21:00:00Z,1
2020-03-07,WV,0,2,3,0,0,5,2020-03-07T21:00:00Z,2
2020-03-08,WV,0,2,3,0,0,5,2020-03-08T20:00:00Z,2
2020-03-09,WV,0,2,3,0,0,5,2020-03-09T20:00:00Z,2
2020-03-10,WV,0,2,3,0,0,5,2020-03-10T20:00:00Z,2
2020-03-11,WV,0,3,2,0,0,5,2020-03-11T20:00:00Z,3
2020-03-12,WV,0,7,1,0,0,8,2020-03-12T20:00:00Z,7
2020-03-13,WV,0,17,4,0,0,21,2020-03-13T20:00:00Z,17
2020-03-14,WV,0,26,5,0,0,31,2020-03-14T20:00:00Z,26
2020-03-15,WV,0,38,1,0,0,39,2020-03-15T20:00:00Z,38
2020-03-16,WV,0,80,4,0,0,84,2020-03-16T20:00:00Z,80
2020-03-17,WV,0,80,4,0,0,84,2020-03-17T20:00:00Z,80
2020-03-18,WV,1,122,14,0,0,137,2020-03-18T20:00:00Z,123
2020-03-19,WV,2,143,3,0,0,148,2020-03-19T20:00:00Z,145
2020-03-20,WV,7,219,13,0,0,239,2020-03-20T20:00:00Z,226
2020-03-21,WV,11,330,2,1,0,343,2020-03-21T20:00:00Z,341
2020-03-22,WV,12,385,1,1,0,398,2020-03-22T20:00:00Z,397
2020-03-23,WV,16,444,4,1,0,464,2020-03-23T20:00:00Z,460
2020-03-24,WV,20,610,0,1,0,630,2020-03-24T20:00:00Z,630
2020-03-07,WY,0,0,0,0,0,0,2020-03-07T21:00:00Z,0
2020-03-08,WY,0,0,0,0,0,0,2020-03-08T20:00:00Z,0
2020-03-09,WY,0,0,0,0,0,0,2020-03-09T20:00:00Z,0
2020-03-10,WY,0,0,0,0,0,0,2020-03-10T20:00:00Z,0
2020-03-11,WY,0,0,0,0,0,0,2020-03-11T20:00:00Z,0
2020-03-12,WY,1,0,0,0,0,1,2020-03-12T20:00:00Z,1
2020-03-13,WY,1,0,0,0,0,1,2020-03-13T20:00:00Z,1
2020-03-14,WY,2,0,0,0,0,2,2020-03-14T20:00:00Z,2
2020-03-15,WY,3,0,0,0,0,3,2020-03-15T20:00:00Z,3
2020-03-16,WY,3,0,0,0,0,3,2020-03-16T20:00:00Z,3
2020-03-17,WY,10,95,0,0,0,105,2020-03-17T20:00:00Z,105
2020-03-18,WY,15,178,0,0,0,193,2020-03-18T20:00:00Z,193
2020-03-19,WY,18,271,0,0,0,289,2020-03-19T20:00:00Z,289
2020-03-20,WY,19,331,0,0,0,350,2020-03-20T20:00:00Z,350
2020-03-21,WY,23,438,0,0,0,461,2020-03-21T20:00:00Z,461
2020-03-22,WY,24,438,0,0,0,462,2020-03-22T20:00:00Z,462
2020-03-23,WY,26,592,0,0,0,618,2020-03-23T20:00:00Z,618
2020-03-24,WY,29,710,0,0,0,739,2020-03-24T20:00:00Z,739
