date,state,positive,negative,pending,hospitalized,death,total,dateChecked,totalTestResults,deathIncrease,hospitalizedIncrease,negativeIncrease,positiveIncrease,totalTestResultsIncrease
2020-03-06,AK,0,8,1,0,0,9,2020-03-06T21:00:00Z,8,0,0,0,0,0
2020-03-07,AK,0,12,2,0,0,14,2020-03-07T21:00:00Z,12,0,0,4,0,4
2020-03-08,AK,0,14,6,0,0,20,2020-03-08T20:00:00Z,14,0,0,2,0,2
2020-03-09,AK,0,23,9,0,0,32,2020-03-09T20:00:00Z,23,0,0,9,0,9
2020-03-10,AK,0,23,9,0,0,32,2020-03-10T20:00:00Z,23,0,0,0,0,0
2020-03-11,AK,0,46,14,0,0,60,2020-03-11T20:00:00Z,46,0,0,23,0,23
2020-03-12,AK,0,46,14,0,0,60,2020-03-12T20:00:00Z,46,0,0,0,0,0
2020-03-13,AK,1,59,0,0,0,60,2020-03-13T20:00:00Z,60,0,0,13,1,14
2020-03-14,AK,1,143,0,0,0,144,2020-03-14T20:00:00Z,144,0,0,84,0,84
2020-03-15,AK,1,143,0,0,0,144,2020-03-15T20:00:00Z,144,0,0,0,0,0
2020-03-16,AK,1,143,0,0,0,144,2020-03-16T20:00:00Z,144,0,0,0,0,0
2020-03-17,AK,3,334,0,0,0,337,2020-03-17T20:00:00Z,337,0,0,191,2,193
2020-03-18,AK,6,406,0,0,0,412,2020-03-18T20:00:00Z,412,0,0,72,3,75
2020-03-19,AK,6,400,0,0,0,406,2020-03-19T20:00:00Z,406,0,0,-6,0,-6
2020-03-20,AK,12,686,0,0,0,698,2020-03-20T20:00:00Z,698,0,0,286,6,292
2020-03-21,AK,14,758,0,0,0,772,2020-03-21T20:00:00Z,772,0,0,72,2,74
2020-03-22,AK,22,946,0,0,0,968,2020-03-22T20:00:00Z,968,0,0,188,8,196
2020-03-23,AK,22,946,0,0,0,968,2020-03-23T20:00:00Z,968,0,0,0,0,0
2020-03-24,AK,36,986,0,0,0,1022,2020-03-24T20:00:00Z,1022,0,0,40,14,54
2020-03-25,AK,42,1649,0,1,1,1691,2020-03-25T20:00:00Z,1691,1,1,663,6,669
2020-03-26,AK,59,1801,0,3,1,1860,2020-03-26T20:00:00Z,1860,0,2,152,17,169
2020-03-07,AL,0,0,0,0,0,0,2020-03-07T21:00:00Z,0,0,0,0,0,0
2020-03-08,AL,0,0,0,0,0,0,2020-03-08T20:00:00Z,0,0,0,0,0,0
2020-03-09,AL,0,0,0,0,0,0,2020-03-09T20:00:00Z,0,0,0,0,0,0
2020-03-10,AL,0,0,0,0,0,0,2020-03-10T20:00:00Z,0,0,0,0,0,0
2020-03-11,AL,0,10,0,0,0,10,2020-03-11T20:00:00Z,10,0,0,10,0,10
2020-03-12,AL,0,10,0,0,0,10,2020-03-12T20:00:00Z,10,0,0,0,0,0
2020-03-13,AL,1,11,0,0,0,12,2020-03-13T20:00:00Z,12,0,0,1,1,2
2020-03-14,AL,6,22,46,0,0,74,2020-03-14T20:00:00Z,28,0,0,11,5,16
2020-03-15,AL,12,28,46,0,0,86,2020-03-15T20:00:00Z,40,0,0,6,6,12
2020-03-16,AL,28,28,40,0,0,96,2020-03-16T20:00:00Z,56,0,0,0,16,16
2020-03-17,AL,36,28,0,0,0,64,2020-03-17T20:00:00Z,64,0,0,0,8,8
2020-03-18,AL,46,28,0,0,0,74,2020-03-18T20:00:00Z,74,0,0,0,10,10
2020-03-19,AL,68,28,0,0,0,96,2020-03-19T20:00:00Z,96,0,0,0,22,22
2020-03-20,AL,81,28,0,0,0,109,2020-03-20T20:00:00Z,109,0,0,0,13,13
2020-03-21,AL,124,28,0,0,0,152,2020-03-21T20:00:00Z,152,0,0,0,43,43
2020-03-22,AL,138,1464,0,0,0,1602,2020-03-22T20:00:00Z,1602,0,0,1436,14,1450
2020-03-23,AL,167,1665,0,0,0,1832,2020-03-23T20:00:00Z,1832,0,0,201,29,230
2020-03-24,AL,215,2106,0,0,0,2321,2020-03-24T20:00:00Z,2321,0,0,441,48,489
2020-03-25,AL,283,2529,0,0,0,2812,2020-03-25T20:00:00Z,2812,0,0,423,68,491
2020-03-26,AL,506,3593,0,0,1,4099,2020-03-26T20:00:00Z,4099,1,0,1064,223,1287
2020-03-06,AR,0,6,0,0,0,6,2020-03-06T21:00:00Z,6,0,0,0,0,0
2020-03-07,AR,0,6,0,0,0,6,2020-03-07T21:00:00Z,6,0,0,0,0,0
2020-03-08,AR,0,6,0,0,0,6,2020-03-08T20:00:00Z,6,0,0,0,0,0
2020-03-09,AR,0,12,0,0,0,12,2020-03-09T20:00:00Z,12,0,0,6,0,6
2020-03-10,AR,0,12,3,0,0,15,2020-03-10T20:00:00Z,12,0,0,0,0,0
2020-03-11,AR,0,12,14,0,0,26,2020-03-11T20:00:00Z,12,0,0,0,0,0
2020-03-12,AR,6,24,20,0,0,50,2020-03-12T20:00:00Z,30,0,0,12,6,18
2020-03-13,AR,9,30,22,0,0,61,2020-03-13T20:00:00Z,39,0,0,6,3,9
2020-03-14,AR,12,65,26,0,0,103,2020-03-14T20:00:00Z,77,0,0,35,3,38
2020-03-15,AR,16,103,30,0,0,149,2020-03-15T20:00:00Z,119,0,0,38,4,42
2020-03-16,AR,22,132,14,0,0,168,2020-03-16T20:00:00Z,154,0,0,29,6,35
2020-03-17,AR,22,197,41,0,0,260,2020-03-17T20:00:00Z,219,0,0,65,0,65
2020-03-18,AR,33,236,50,0,0,319,2020-03-18T20:00:00Z,269,0,0,39,11,50
2020-03-19,AR,46,310,113,0,0,469,2020-03-19T20:00:00Z,356,0,0,74,13,87
2020-03-20,AR,96,351,203,0,0,650,2020-03-20T20:00:00Z,447,0,0,41,50,91
2020-03-21,AR,118,567,154,0,0,839,2020-03-21T20:00:00Z,685,0,0,216,22,238
2020-03-22,AR,165,711,119,13,0,995,2020-03-22T20:00:00Z,876,0,13,144,47,191
2020-03-23,AR,174,906,0,13,0,1080,2020-03-23T20:00:00Z,1080,0,0,195,9,204
2020-03-24,AR,218,947,0,22,0,1165,2020-03-24T20:00:00Z,1165,0,9,41,44,85
2020-03-25,AR,280,1437,0,22,2,1717,2020-03-25T20:00:00Z,1717,2,0,490,62,552
2020-03-26,AR,335,1504,0,41,3,1839,2020-03-26T20:00:00Z,1839,1,19,67,55,122
2020-03-16,AS,0,0,0,0,0,0,2020-03-16T20:00:00Z,0,0,0,0,0,0
2020-03-17,AS,0,0,0,0,0,0,2020-03-17T20:00:00Z,0,0,0,0,0,0
2020-03-18,AS,0,0,0,0,0,0,2020-03-18T20:00:00Z,0,0,0,0,0,0
2020-03-19,AS,0,0,0,0,0,0,2020-03-19T20:00:00Z,0,0,0,0,0,0
2020-03-20,AS,0,0,0,0,0,0,2020-03-20T20:00:00Z,0,0,0,0,0,0
2020-03-21,AS,0,0,0,0,0,0,2020-03-21T20:00:00Z,0,0,0,0,0,0
2020-03-22,AS,0,0,0,0,0,0,2020-03-22T20:00:00Z,0,0,0,0,0,0
2020-03-23,AS,0,0,0,0,0,0,2020-03-23T20:00:00Z,0,0,0,0,0,0
2020-03-24,AS,0,0,0,0,0,0,2020-03-24T20:00:00Z,0,0,0,0,0,0
2020-03-25,AS,0,0,0,0,0,0,2020-03-25T20:00:00Z,0,0,0,0,0,0
2020-03-26,AS,0,0,0,0,0,0,2020-03-26T20:00:00Z,0,0,0,0,0,0
2020-03-04,AZ,2,27,5,0,0,34,2020-03-04T21:00:00Z,29,0,0,0,0,0
2020-03-05,AZ,2,28,6,0,0,36,2020-03-05T21:00:00Z,30,0,0,1,0,1
2020-03-06,AZ,3,33,15,0,0,51,2020-03-06T21:00:00Z,36,0,0,5,1,6
2020-03-07,AZ,5,44,7,0,0,56,2020-03-07T21:00:00Z,49,0,0,11,2,13
2020-03-08,AZ,5,44,7,0,0,56,2020-03-08T20:00:00Z,49,0,0,0,0,0
2020-03-09,AZ,5,44,7,0,0,56,2020-03-09T20:00:00Z,49,0,0,0,0,0
2020-03-10,AZ,6,51,27,0,0,84,2020-03-10T20:00:00Z,57,0,0,7,1,8
2020-03-11,AZ,9,59,32,0,0,100,2020-03-11T20:00:00Z,68,0,0,8,3,11
2020-03-12,AZ,9,82,24,0,0,115,2020-03-12T20:00:00Z,91,0,0,23,0,23
2020-03-13,AZ,9,94,40,0,0,143,2020-03-13T20:00:00Z,103,0,0,12,0,12
2020-03-14,AZ,12,121,50,0,0,183,2020-03-14T20:00:00Z,133,0,0,27,3,30
2020-03-15,AZ,12,121,50,0,0,183,2020-03-15T20:00:00Z,133,0,0,0,0,0
2020-03-16,AZ,18,125,63,0,0,206,2020-03-16T20:00:00Z,143,0,0,4,6,10
2020-03-17,AZ,20,142,66,0,0,228,2020-03-17T20:00:00Z,162,0,0,17,2,19
2020-03-18,AZ,28,148,102,0,0,278,2020-03-18T20:00:00Z,176,0,0,6,8,14
2020-03-19,AZ,44,175,130,0,0,349,2020-03-19T20:00:00Z,219,0,0,27,16,43
2020-03-20,AZ,65,211,101,0,0,377,2020-03-20T20:00:00Z,276,0,0,36,21,57
2020-03-21,AZ,104,240,122,0,1,466,2020-03-21T20:00:00Z,344,1,0,29,39,68
2020-03-22,AZ,152,282,87,0,2,521,2020-03-22T20:00:00Z,434,1,0,42,48,90
2020-03-23,AZ,265,309,6,0,2,580,2020-03-23T20:00:00Z,574,0,0,27,113,140
2020-03-24,AZ,357,313,22,8,5,692,2020-03-24T20:00:00Z,670,3,8,4,92,96
2020-03-25,AZ,450,323,53,8,6,826,2020-03-25T20:00:00Z,773,1,0,10,93,103
2020-03-26,AZ,577,347,33,66,8,957,2020-03-26T20:00:00Z,924,2,58,24,127,151
2020-03-04,CA,53,462,0,0,0,515,2020-03-04T21:00:00Z,515,0,0,0,0,0
2020-03-05,CA,53,462,0,0,0,515,2020-03-05T21:00:00Z,515,0,0,0,0,0
2020-03-06,CA,60,462,0,0,0,522,2020-03-06T21:00:00Z,522,0,0,0,7,7
2020-03-07,CA,69,462,0,0,0,531,2020-03-07T21:00:00Z,531,0,0,0,9,9
2020-03-08,CA,88,462,0,0,0,550,2020-03-08T20:00:00Z,550,0,0,0,19,19
2020-03-09,CA,114,690,0,0,0,804,2020-03-09T20:00:00Z,804,0,0,228,26,254
2020-03-10,CA,133,690,0,0,0,823,2020-03-10T20:00:00Z,823,0,0,0,19,19
2020-03-11,CA,157,916,0,0,0,1073,2020-03-11T20:00:00Z,1073,0,0,226,24,250
2020-03-12,CA,202,916,0,0,4,1118,2020-03-12T20:00:00Z,1118,4,0,0,45,45
2020-03-13,CA,202,916,0,0,4,1118,2020-03-13T20:00:00Z,1118,0,0,0,0,0
2020-03-14,CA,252,916,0,0,5,1168,2020-03-14T20:00:00Z,1168,1,0,0,50,50
2020-03-15,CA,293,916,0,0,5,1209,2020-03-15T20:00:00Z,1209,0,0,0,41,41
2020-03-16,CA,335,7981,0,0,6,8316,2020-03-16T20:00:00Z,8316,1,0,7065,42,7107
2020-03-17,CA,483,7981,0,0,11,8464,2020-03-17T20:00:00Z,8464,5,0,0,148,148
2020-03-18,CA,611,7981,0,0,13,8592,2020-03-18T20:00:00Z,8592,2,0,0,128,128
2020-03-19,CA,924,8787,0,0,18,9711,2020-03-19T20:00:00Z,9711,5,0,806,313,1119
2020-03-20,CA,1063,10424,0,0,20,11487,2020-03-20T20:00:00Z,11487,2,0,1637,139,1776
2020-03-21,CA,1279,11249,0,0,24,12528,2020-03-21T20:00:00Z,12528,4,0,825,216,1041
2020-03-22,CA,1536,11304,0,0,27,12840,2020-03-22T20:00:00Z,12840,3,0,55,257,312
2020-03-23,CA,1733,12567,12100,0,27,26400,2020-03-23T20:00:00Z,14300,0,0,1263,197,1460
2020-03-24,CA,2102,13452,12100,0,40,27654,2020-03-24T20:00:00Z,15554,13,0,885,369,1254
2020-03-25,CA,2355,15921,48600,0,53,66876,2020-03-25T20:00:00Z,18276,13,0,2469,253,2722
2020-03-26,CA,3006,17380,57400,0,65,77786,2020-03-26T20:00:00Z,20386,12,0,1459,651,2110
2020-03-05,CO,0,19,21,0,0,40,2020-03-05T21:00:00Z,19,0,0,0,0,0
2020-03-06,CO,2,46,30,0,0,78,2020-03-06T21:00:00Z,48,0,0,27,2,29
2020-03-07,CO,8,55,69,0,0,132,2020-03-07T21:00:00Z,63,0,0,9,6,15
2020-03-08,CO,8,104,0,0,0,112,2020-03-08T20:00:00Z,112,0,0,49,0,49
2020-03-09,CO,9,133,0,0,0,142,2020-03-09T20:00:00Z,142,0,0,29,1,30
2020-03-10,CO,12,142,1,0,0,155,2020-03-10T20:00:00Z,154,0,0,9,3,12
2020-03-11,CO,28,251,0,0,0,279,2020-03-11T20:00:00Z,279,0,0,109,16,125
2020-03-12,CO,45,298,0,0,0,343,2020-03-12T20:00:00Z,343,0,0,47,17,64
2020-03-13,CO,72,524,0,0,0,596,2020-03-13T20:00:00Z,596,0,0,226,27,253
2020-03-14,CO,101,610,0,0,1,711,2020-03-14T20:00:00Z,711,1,0,86,29,115
2020-03-15,CO,131,627,0,0,1,758,2020-03-15T20:00:00Z,758,0,0,17,30,47
2020-03-16,CO,131,627,0,0,1,758,2020-03-16T20:00:00Z,758,0,0,0,0,0
2020-03-17,CO,160,1056,0,0,1,1216,2020-03-17T20:00:00Z,1216,0,0,429,29,458
2020-03-18,CO,183,1617,0,0,2,1800,2020-03-18T20:00:00Z,1800,1,0,561,23,584
2020-03-19,CO,216,2112,0,0,2,2328,2020-03-19T20:00:00Z,2328,0,0,495,33,528
2020-03-20,CO,277,2675,0,0,3,2952,2020-03-20T20:00:00Z,2952,1,0,563,61,624
2020-03-21,CO,363,3317,0,44,4,3680,2020-03-21T20:00:00Z,3680,1,44,642,86,728
2020-03-22,CO,475,4075,0,49,5,4550,2020-03-22T20:00:00Z,4550,1,5,758,112,870
2020-03-23,CO,591,4845,0,58,6,5436,2020-03-23T20:00:00Z,5436,1,9,770,116,886
2020-03-24,CO,720,5504,0,72,7,6224,2020-03-24T20:00:00Z,6224,1,14,659,129,788
2020-03-25,CO,912,6789,0,84,11,7701,2020-03-25T20:00:00Z,7701,4,12,1285,192,1477
2020-03-26,CO,1086,6978,0,148,19,8064,2020-03-26T20:00:00Z,8064,8,64,189,174,363
2020-03-07,CT,0,0,0,0,0,0,2020-03-07T21:00:00Z,0,0,0,0,0,0
2020-03-08,CT,1,29,8,0,0,38,2020-03-08T20:00:00Z,30,0,0,29,1,30
2020-03-09,CT,1,46,0,0,0,47,2020-03-09T20:00:00Z,47,0,0,17,0,17
2020-03-10,CT,2,54,0,0,0,56,2020-03-10T20:00:00Z,56,0,0,8,1,9
2020-03-11,CT,3,71,0,0,0,74,2020-03-11T20:00:00Z,74,0,0,17,1,18
2020-03-12,CT,6,89,0,0,0,95,2020-03-12T20:00:00Z,95,0,0,18,3,21
2020-03-13,CT,6,99,0,0,0,105,2020-03-13T20:00:00Z,105,0,0,10,0,10
2020-03-14,CT,11,125,0,0,0,136,2020-03-14T20:00:00Z,136,0,0,26,5,31
2020-03-15,CT,20,125,0,0,0,145,2020-03-15T20:00:00Z,145,0,0,0,9,9
2020-03-16,CT,26,125,0,0,0,151,2020-03-16T20:00:00Z,151,0,0,0,6,6
2020-03-17,CT,41,125,0,0,0,166,2020-03-17T20:00:00Z,166,0,0,0,15,15
2020-03-18,CT,68,125,0,0,0,193,2020-03-18T20:00:00Z,193,0,0,0,27,27
2020-03-19,CT,96,604,0,0,1,700,2020-03-19T20:00:00Z,700,1,0,479,28,507
2020-03-20,CT,194,604,0,0,3,798,2020-03-20T20:00:00Z,798,2,0,0,98,98
2020-03-21,CT,194,2106,0,0,4,2300,2020-03-21T20:00:00Z,2300,1,0,1502,0,1502
2020-03-22,CT,223,2877,0,43,5,3100,2020-03-22T20:00:00Z,3100,1,43,771,29,800
2020-03-23,CT,415,4085,0,54,10,4500,2020-03-23T20:00:00Z,4500,5,11,1208,192,1400
2020-03-24,CT,618,4682,0,71,12,5300,2020-03-24T20:00:00Z,5300,2,17,597,203,800
2020-03-25,CT,875,5023,0,113,19,5898,2020-03-25T20:00:00Z,5898,7,42,341,257,598
2020-03-26,CT,1012,5625,0,125,21,6637,2020-03-26T20:00:00Z,6637,2,12,602,137,739
2020-03-05,DC,0,6,2,0,0,8,2020-03-05T21:00:00Z,6,0,0,0,0,0
2020-03-06,DC,0,8,1,0,0,9,2020-03-06T21:00:00Z,8,0,0,2,0,2
2020-03-07,DC,0,8,1,0,0,9,2020-03-07T21:00:00Z,8,0,0,0,0,0
2020-03-08,DC,1,10,0,0,0,11,2020-03-08T20:00:00Z,11,0,0,2,1,3
2020-03-09,DC,1,14,3,0,0,18,2020-03-09T20:00:00Z,15,0,0,4,0,4
2020-03-10,DC,5,17,2,0,0,24,2020-03-10T20:00:00Z,22,0,0,3,4,7
2020-03-11,DC,4,20,15,0,0,39,2020-03-11T20:00:00Z,24,0,0,3,-1,2
2020-03-12,DC,10,20,0,0,0,30,2020-03-12T20:00:00Z,30,0,0,0,6,6
2020-03-13,DC,10,20,0,0,0,30,2020-03-13T20:00:00Z,30,0,0,0,0,0
2020-03-14,DC,10,49,10,0,0,69,2020-03-14T20:00:00Z,59,0,0,29,0,29
2020-03-15,DC,16,79,20,0,0,115,2020-03-15T20:00:00Z,95,0,0,30,6,36
2020-03-16,DC,17,96,7,0,0,120,2020-03-16T20:00:00Z,113,0,0,17,1,18
2020-03-17,DC,22,104,0,0,0,126,2020-03-17T20:00:00Z,126,0,0,8,5,13
2020-03-18,DC,31,138,1,0,0,170,2020-03-18T20:00:00Z,169,0,0,34,9,43
2020-03-19,DC,39,153,11,0,0,203,2020-03-19T20:00:00Z,192,0,0,15,8,23
2020-03-20,DC,71,501,1,0,1,573,2020-03-20T20:00:00Z,572,1,0,348,32,380
2020-03-21,DC,77,506,0,0,1,583,2020-03-21T20:00:00Z,583,0,0,5,6,11
2020-03-22,DC,98,957,0,0,1,1055,2020-03-22T20:00:00Z,1055,0,0,451,21,472
2020-03-23,DC,116,1113,0,0,2,1229,2020-03-23T20:00:00Z,1229,1,0,156,18,174
2020-03-24,DC,137,1195,2,0,2,1334,2020-03-24T20:00:00Z,1332,0,0,82,21,103
2020-03-25,DC,183,1423,3,0,2,1609,2020-03-25T20:00:00Z,1606,0,0,228,46,274
2020-03-26,DC,231,1626,1,0,3,1858,2020-03-26T20:00:00Z,1857,1,0,203,48,251
2020-03-06,DE,0,10,0,0,0,10,2020-03-06T21:00:00Z,10,0,0,0,0,0
2020-03-07,DE,0,10,0,0,0,10,2020-03-07T21:00:00Z,10,0,0,0,0,0
2020-03-08,DE,0,10,0,0,0,10,2020-03-08T20:00:00Z,10,0,0,0,0,0
2020-03-09,DE,0,15,3,0,0,18,2020-03-09T20:00:00Z,15,0,0,5,0,5
2020-03-10,DE,0,17,3,0,0,20,2020-03-10T20:00:00Z,17,0,0,2,0,2
2020-03-11,DE,1,17,2,0,0,20,2020-03-11T20:00:00Z,18,0,0,0,1,1
2020-03-12,DE,4,23,14,0,0,41,2020-03-12T20:00:00Z,27,0,0,6,3,9
2020-03-13,DE,4,30,10,0,0,44,2020-03-13T20:00:00Z,34,0,0,7,0,7
2020-03-14,DE,6,36,32,0,0,74,2020-03-14T20:00:00Z,42,0,0,6,2,8
2020-03-15,DE,6,36,32,0,0,74,2020-03-15T20:00:00Z,42,0,0,0,0,0
2020-03-16,DE,8,36,32,0,0,76,2020-03-16T20:00:00Z,44,0,0,0,2,2
2020-03-17,DE,16,36,0,0,0,52,2020-03-17T20:00:00Z,52,0,0,0,8,8
2020-03-18,DE,25,36,0,0,0,61,2020-03-18T20:00:00Z,61,0,0,0,9,9
2020-03-19,DE,30,36,0,0,0,66,2020-03-19T20:00:00Z,66,0,0,0,5,5
2020-03-20,DE,38,36,0,0,0,74,2020-03-20T20:00:00Z,74,0,0,0,8,8
2020-03-21,DE,45,36,0,0,0,81,2020-03-21T20:00:00Z,81,0,0,0,7,7
2020-03-22,DE,56,36,0,0,0,92,2020-03-22T20:00:00Z,92,0,0,0,11,11
2020-03-23,DE,68,36,0,0,0,104,2020-03-23T20:00:00Z,104,0,0,0,12,12
2020-03-24,DE,91,36,0,0,0,127,2020-03-24T20:00:00Z,127,0,0,0,23,23
2020-03-25,DE,115,36,0,11,0,151,2020-03-25T20:00:00Z,151,0,11,0,24,24
2020-03-26,DE,130,36,0,13,1,166,2020-03-26T20:00:00Z,166,1,2,0,15,15
2020-03-04,FL,2,24,16,0,0,42,2020-03-04T21:00:00Z,26,0,0,0,0,0
2020-03-05,FL,9,31,69,0,0,109,2020-03-05T21:00:00Z,40,0,0,7,7,14
2020-03-06,FL,9,55,51,0,0,115,2020-03-06T21:00:00Z,64,0,0,24,0,24
2020-03-07,FL,14,100,88,0,0,202,2020-03-07T21:00:00Z,114,0,0,45,5,50
2020-03-08,FL,17,118,108,0,0,243,2020-03-08T20:00:00Z,135,0,0,18,3,21
2020-03-09,FL,18,140,115,0,0,273,2020-03-09T20:00:00Z,158,0,0,22,1,23
2020-03-10,FL,19,222,155,0,0,396,2020-03-10T20:00:00Z,241,0,0,82,1,83
2020-03-11,FL,28,301,147,0,2,476,2020-03-11T20:00:00Z,329,2,0,79,9,88
2020-03-12,FL,32,301,147,0,2,480,2020-03-12T20:00:00Z,333,0,0,0,4,4
2020-03-13,FL,50,478,221,0,2,749,2020-03-13T20:00:00Z,528,0,0,177,18,195
2020-03-14,FL,77,478,221,0,3,776,2020-03-14T20:00:00Z,555,1,0,0,27,27
2020-03-15,FL,116,678,454,0,4,1248,2020-03-15T20:00:00Z,794,1,0,200,39,239
2020-03-16,FL,141,684,514,0,4,1339,2020-03-16T20:00:00Z,825,0,0,6,25,31
2020-03-17,FL,186,940,872,0,6,1998,2020-03-17T20:00:00Z,1126,2,0,256,45,301
2020-03-18,FL,314,1225,954,0,7,2493,2020-03-18T20:00:00Z,1539,1,0,285,128,413
2020-03-19,FL,390,1533,1019,0,8,2942,2020-03-19T20:00:00Z,1923,1,0,308,76,384
2020-03-20,FL,520,1870,1026,0,10,3416,2020-03-20T20:00:00Z,2390,2,0,337,130,467
2020-03-21,FL,658,6579,1002,158,12,8239,2020-03-21T20:00:00Z,7237,2,158,4709,138,4847
2020-03-22,FL,830,7990,963,185,13,9783,2020-03-22T20:00:00Z,8820,1,27,1411,172,1583
2020-03-23,FL,1171,11063,860,217,14,13094,2020-03-23T20:00:00Z,12234,1,32,3073,341,3414
2020-03-24,FL,1412,13127,1008,259,18,15547,2020-03-24T20:00:00Z,14539,4,42,2064,241,2305
2020-03-25,FL,1682,15374,1233,316,22,18289,2020-03-25T20:00:00Z,17056,4,57,2247,270,2517
2020-03-26,FL,2355,23741,1443,406,28,27539,2020-03-26T20:00:00Z,26096,6,90,8367,673,9040
2020-03-04,GA,2,0,0,0,0,2,2020-03-04T21:00:00Z,2,0,0,0,0,0
2020-03-05,GA,2,0,0,0,0,2,2020-03-05T21:00:00Z,2,0,0,0,0,0
2020-03-06,GA,2,0,0,0,0,2,2020-03-06T21:00:00Z,2,0,0,0,0,0
2020-03-07,GA,6,0,0,0,0,6,2020-03-07T21:00:00Z,6,0,0,0,4,4
2020-03-08,GA,7,0,0,0,0,7,2020-03-08T20:00:00Z,7,0,0,0,1,1
2020-03-09,GA,12,0,0,0,0,12,2020-03-09T20:00:00Z,12,0,0,0,5,5
2020-03-10,GA,17,0,0,0,0,17,2020-03-10T20:00:00Z,17,0,0,0,5,5
2020-03-11,GA,22,0,0,0,0,22,2020-03-11T20:00:00Z,22,0,0,0,5,5
2020-03-12,GA,31,0,0,0,0,31,2020-03-12T20:00:00Z,31,0,0,0,9,9
2020-03-13,GA,42,0,0,0,1,42,2020-03-13T20:00:00Z,42,1,0,0,11,11
2020-03-14,GA,66,0,0,0,1,66,2020-03-14T20:00:00Z,66,0,0,0,24,24
2020-03-15,GA,99,0,0,0,1,99,2020-03-15T20:00:00Z,99,0,0,0,33,33
2020-03-16,GA,121,0,0,0,1,121,2020-03-16T20:00:00Z,121,0,0,0,22,22
2020-03-17,GA,146,0,0,0,1,146,2020-03-17T20:00:00Z,146,0,0,0,25,25
2020-03-18,GA,197,1311,0,0,1,1508,2020-03-18T20:00:00Z,1508,0,0,1311,51,1362
2020-03-19,GA,287,1544,0,0,10,1831,2020-03-19T20:00:00Z,1831,9,0,233,90,323
2020-03-20,GA,420,1966,0,0,13,2386,2020-03-20T20:00:00Z,2386,3,0,422,133,555
2020-03-21,GA,507,2557,0,0,14,3064,2020-03-21T20:00:00Z,3064,1,0,591,87,678
2020-03-22,GA,600,3420,0,0,23,4020,2020-03-22T20:00:00Z,4020,9,0,863,93,956
2020-03-23,GA,772,4297,0,0,25,5069,2020-03-23T20:00:00Z,5069,2,0,877,172,1049
2020-03-24,GA,1026,4458,0,0,32,5484,2020-03-24T20:00:00Z,5484,7,0,161,254,415
2020-03-25,GA,1247,4932,0,394,40,6179,2020-03-25T20:00:00Z,6179,8,394,474,221,695
2020-03-26,GA,1525,7401,0,473,48,8926,2020-03-26T20:00:00Z,8926,8,79,2469,278,2747
2020-03-16,GU,3,23,0,0,0,26,2020-03-16T20:00:00Z,26,0,0,0,0,0
2020-03-17,GU,5,41,0,0,0,46,2020-03-17T20:00:00Z,46,0,0,18,2,20
2020-03-18,GU,8,57,0,0,0,65,2020-03-18T20:00:00Z,65,0,0,16,3,19
2020-03-19,GU,12,69,0,0,0,81,2020-03-19T20:00:00Z,81,0,0,12,4,16
2020-03-20,GU,14,86,0,0,0,100,2020-03-20T20:00:00Z,100,0,0,17,2,19
2020-03-21,GU,15,108,0,0,0,123,2020-03-21T20:00:00Z,123,0,0,22,1,23
2020-03-22,GU,27,126,0,0,1,153,2020-03-22T20:00:00Z,153,1,0,18,12,30
2020-03-23,GU,29,161,0,0,1,190,2020-03-23T20:00:00Z,190,0,0,35,2,37
2020-03-24,GU,32,201,0,5,1,233,2020-03-24T20:00:00Z,233,0,5,40,3,43
2020-03-25,GU,37,233,0,10,1,270,2020-03-25T20:00:00Z,270,0,5,32,5,37
2020-03-26,GU,45,263,0,11,1,308,2020-03-26T20:00:00Z,308,0,1,30,8,38
2020-03-07,HI,1,0,0,0,0,1,2020-03-07T21:00:00Z,1,0,0,0,0,0
2020-03-08,HI,1,0,0,0,0,1,2020-03-08T20:00:00Z,1,0,0,0,0,0
2020-03-09,HI,2,0,0,0,0,2,2020-03-09T20:00:00Z,2,0,0,0,1,1
2020-03-10,HI,2,0,0,0,0,2,2020-03-10T20:00:00Z,2,0,0,0,0,0
2020-03-11,HI,2,0,0,0,0,2,2020-03-11T20:00:00Z,2,0,0,0,0,0
2020-03-12,HI,2,0,0,0,0,2,2020-03-12T20:00:00Z,2,0,0,0,0,0
2020-03-13,HI,2,0,0,0,0,2,2020-03-13T20:00:00Z,2,0,0,0,0,0
2020-03-14,HI,2,0,0,0,0,2,2020-03-14T20:00:00Z,2,0,0,0,0,0
2020-03-15,HI,2,0,0,0,0,2,2020-03-15T20:00:00Z,2,0,0,0,0,0
2020-03-16,HI,7,0,0,0,0,7,2020-03-16T20:00:00Z,7,0,0,0,5,5
2020-03-17,HI,10,0,0,0,0,10,2020-03-17T20:00:00Z,10,0,0,0,3,3
2020-03-18,HI,14,93,12,0,0,119,2020-03-18T20:00:00Z,107,0,0,93,4,97
2020-03-19,HI,16,93,9,0,0,118,2020-03-19T20:00:00Z,109,0,0,0,2,2
2020-03-20,HI,26,124,9,0,0,159,2020-03-20T20:00:00Z,150,0,0,31,10,41
2020-03-21,HI,37,124,9,0,0,170,2020-03-21T20:00:00Z,161,0,0,0,11,11
2020-03-22,HI,48,263,0,0,0,311,2020-03-22T20:00:00Z,311,0,0,139,11,150
2020-03-23,HI,56,2955,0,0,0,3011,2020-03-23T20:00:00Z,3011,0,0,2692,8,2700
2020-03-24,HI,77,3589,0,4,1,3666,2020-03-24T20:00:00Z,3666,1,4,634,21,655
2020-03-25,HI,90,4357,0,6,1,4447,2020-03-25T20:00:00Z,4447,0,2,768,13,781
2020-03-26,HI,95,4357,0,5,0,4452,2020-03-26T20:00:00Z,4452,0,-1,0,5,5
2020-03-06,IA,0,15,2,0,0,17,2020-03-06T21:00:00Z,15,0,0,0,0,0
2020-03-07,IA,0,15,2,0,0,17,2020-03-07T21:00:00Z,15,0,0,0,0,0
2020-03-08,IA,0,15,2,0,0,17,2020-03-08T20:00:00Z,15,0,0,0,0,0
2020-03-09,IA,3,26,8,0,0,37,2020-03-09T20:00:00Z,29,0,0,11,3,14
2020-03-10,IA,8,32,11,0,0,51,2020-03-10T20:00:00Z,40,0,0,6,5,11
2020-03-11,IA,13,46,27,0,0,86,2020-03-11T20:00:00Z,59,0,0,14,5,19
2020-03-12,IA,14,67,24,0,0,105,2020-03-12T20:00:00Z,81,0,0,21,1,22
2020-03-13,IA,16,83,29,0,0,128,2020-03-13T20:00:00Z,99,0,0,16,2,18
2020-03-14,IA,17,83,0,0,0,100,2020-03-14T20:00:00Z,100,0,0,0,1,1
2020-03-15,IA,18,83,0,0,0,101,2020-03-15T20:00:00Z,101,0,0,0,1,1
2020-03-16,IA,22,83,0,0,0,105,2020-03-16T20:00:00Z,105,0,0,0,4,4
2020-03-17,IA,23,83,0,0,0,106,2020-03-17T20:00:00Z,106,0,0,0,1,1
2020-03-18,IA,29,83,0,0,0,112,2020-03-18T20:00:00Z,112,0,0,0,6,6
2020-03-19,IA,38,83,0,0,0,121,2020-03-19T20:00:00Z,121,0,0,0,9,9
2020-03-20,IA,45,642,0,0,0,687,2020-03-20T20:00:00Z,687,0,0,559,7,566
2020-03-21,IA,68,1049,0,0,0,1117,2020-03-21T20:00:00Z,1117,0,0,407,23,430
2020-03-22,IA,90,1215,0,0,0,1305,2020-03-22T20:00:00Z,1305,0,0,166,22,188
2020-03-23,IA,105,2043,0,0,0,2148,2020-03-23T20:00:00Z,2148,0,0,828,15,843
2020-03-24,IA,124,2315,0,27,0,2439,2020-03-24T20:00:00Z,2439,0,27,272,19,291
2020-03-25,IA,145,2578,0,36,1,2723,2020-03-25T20:00:00Z,2723,1,9,263,21,284
2020-03-26,IA,179,2578,0,46,1,2757,2020-03-26T20:00:00Z,2757,0,10,0,34,34
2020-03-07,ID,0,27,0,0,0,27,2020-03-07T21:00:00Z,27,0,0,0,0,0
2020-03-08,ID,0,27,0,0,0,27,2020-03-08T20:00:00Z,27,0,0,0,0,0
2020-03-09,ID,0,41,0,0,0,41,2020-03-09T20:00:00Z,41,0,0,14,0,14
2020-03-10,ID,0,41,0,0,0,41,2020-03-10T20:00:00Z,41,0,0,0,0,0
2020-03-11,ID,0,67,0,0,0,67,2020-03-11T20:00:00Z,67,0,0,26,0,26
2020-03-12,ID,0,93,0,0,0,93,2020-03-12T20:00:00Z,93,0,0,26,0,26
2020-03-13,ID,0,131,0,0,0,131,2020-03-13T20:00:00Z,131,0,0,38,0,38
2020-03-14,ID,2,174,0,0,0,176,2020-03-14T20:00:00Z,176,0,0,43,2,45
2020-03-15,ID,5,171,0,0,0,176,2020-03-15T20:00:00Z,176,0,0,-3,3,0
2020-03-16,ID,5,265,0,0,0,270,2020-03-16T20:00:00Z,270,0,0,94,0,94
2020-03-17,ID,7,346,0,0,0,353,2020-03-17T20:00:00Z,353,0,0,81,2,83
2020-03-18,ID,9,459,0,0,0,468,2020-03-18T20:00:00Z,468,0,0,113,2,115
2020-03-19,ID,11,457,0,0,0,468,2020-03-19T20:00:00Z,468,0,0,-2,2,0
2020-03-20,ID,23,590,0,0,0,613,2020-03-20T20:00:00Z,613,0,0,133,12,145
2020-03-21,ID,31,880,0,0,0,911,2020-03-21T20:00:00Z,911,0,0,290,8,298
2020-03-22,ID,42,1175,0,0,0,1217,2020-03-22T20:00:00Z,1217,0,0,295,11,306
2020-03-23,ID,47,1309,0,0,0,1356,2020-03-23T20:00:00Z,1356,0,0,134,5,139
2020-03-24,ID,50,1887,0,0,0,1937,2020-03-24T20:00:00Z,1937,0,0,578,3,581
2020-03-25,ID,73,1887,0,0,0,1960,2020-03-25T20:00:00Z,1960,0,0,0,23,23
2020-03-26,ID,123,2065,0,0,0,2188,2020-03-26T20:00:00Z,2188,0,0,178,50,228
2020-03-04,IL,4,124,27,0,0,155,2020-03-04T21:00:00Z,128,0,0,0,0,0
2020-03-05,IL,5,165,27,0,0,197,2020-03-05T21:00:00Z,170,0,0,41,1,42
2020-03-06,IL,5,180,35,0,0,220,2020-03-06T21:00:00Z,185,0,0,15,0,15
2020-03-07,IL,6,191,44,0,0,241,2020-03-07T21:00:00Z,197,0,0,11,1,12
2020-03-08,IL,6,191,44,0,0,241,2020-03-08T20:00:00Z,197,0,0,0,0,0
2020-03-09,IL,7,191,44,0,0,242,2020-03-09T20:00:00Z,198,0,0,0,1,1
2020-03-10,IL,19,244,63,0,0,326,2020-03-10T20:00:00Z,263,0,0,53,12,65
2020-03-11,IL,19,244,63,0,0,326,2020-03-11T20:00:00Z,263,0,0,0,0,0
2020-03-12,IL,25,266,76,0,0,367,2020-03-12T20:00:00Z,291,0,0,22,6,28
2020-03-13,IL,32,294,92,0,0,418,2020-03-13T20:00:00Z,326,0,0,28,7,35
2020-03-14,IL,46,316,82,0,0,444,2020-03-14T20:00:00Z,362,0,0,22,14,36
2020-03-15,IL,64,449,195,0,0,708,2020-03-15T20:00:00Z,513,0,0,133,18,151
2020-03-16,IL,93,932,0,0,0,1025,2020-03-16T20:00:00Z,1025,0,0,483,29,512
2020-03-17,IL,160,1340,0,0,1,1500,2020-03-17T20:00:00Z,1500,1,0,408,67,475
2020-03-18,IL,288,1763,0,0,1,2051,2020-03-18T20:00:00Z,2051,0,0,423,128,551
2020-03-19,IL,422,2725,0,0,4,3147,2020-03-19T20:00:00Z,3147,3,0,962,134,1096
2020-03-20,IL,585,3696,0,0,5,4281,2020-03-20T20:00:00Z,4281,1,0,971,163,1134
2020-03-21,IL,753,5488,0,0,6,6241,2020-03-21T20:00:00Z,6241,1,0,1792,168,1960
2020-03-22,IL,1049,7271,0,0,9,8320,2020-03-22T20:00:00Z,8320,3,0,1783,296,2079
2020-03-23,IL,1273,8583,0,0,12,9856,2020-03-23T20:00:00Z,9856,3,0,1312,224,1536
2020-03-24,IL,1535,9934,0,0,16,11469,2020-03-24T20:00:00Z,11469,4,0,1351,262,1613
2020-03-25,IL,1865,12344,0,0,19,14209,2020-03-25T20:00:00Z,14209,3,0,2410,330,2740
2020-03-26,IL,2538,14093,0,0,26,16631,2020-03-26T20:00:00Z,16631,7,0,1749,673,2422
2020-03-06,IN,1,0,0,0,0,1,2020-03-06T21:00:00Z,1,0,0,0,0,0
2020-03-07,IN,1,0,0,0,0,1,2020-03-07T21:00:00Z,1,0,0,0,0,0
2020-03-08,IN,2,0,0,0,0,2,2020-03-08T20:00:00Z,2,0,0,0,1,1
2020-03-09,IN,2,0,0,0,0,2,2020-03-09T20:00:00Z,2,0,0,0,0,0
2020-03-10,IN,6,30,0,0,0,36,2020-03-10T20:00:00Z,36,0,0,30,4,34
2020-03-11,IN,10,33,0,0,0,43,2020-03-11T20:00:00Z,43,0,0,3,4,7
2020-03-12,IN,12,52,0,0,0,64,2020-03-12T20:00:00Z,64,0,0,19,2,21
2020-03-13,IN,12,61,0,0,0,73,2020-03-13T20:00:00Z,73,0,0,9,0,9
2020-03-14,IN,15,74,0,0,0,89,2020-03-14T20:00:00Z,89,0,0,13,3,16
2020-03-15,IN,19,102,0,0,0,121,2020-03-15T20:00:00Z,121,0,0,28,4,32
2020-03-16,IN,24,115,0,0,1,139,2020-03-16T20:00:00Z,139,1,0,13,5,18
2020-03-17,IN,30,129,0,0,2,159,2020-03-17T20:00:00Z,159,1,0,14,6,20
2020-03-18,IN,39,154,0,0,2,193,2020-03-18T20:00:00Z,193,0,0,25,9,34
2020-03-19,IN,56,324,0,0,2,380,2020-03-19T20:00:00Z,380,0,0,170,17,187
2020-03-20,IN,79,475,0,0,2,554,2020-03-20T20:00:00Z,554,0,0,151,23,174
2020-03-21,IN,126,707,0,1,4,833,2020-03-21T20:00:00Z,833,2,1,232,47,279
2020-03-22,IN,201,1293,0,1,6,1494,2020-03-22T20:00:00Z,1494,2,0,586,75,661
2020-03-23,IN,259,1701,0,1,7,1960,2020-03-23T20:00:00Z,1960,1,0,408,58,466
2020-03-24,IN,365,2566,0,1,12,2931,2020-03-24T20:00:00Z,2931,5,0,865,106,971
2020-03-25,IN,477,2879,0,1,14,3356,2020-03-25T20:00:00Z,3356,2,0,313,112,425
2020-03-26,IN,645,4006,0,0,17,4651,2020-03-26T20:00:00Z,4651,3,0,1127,168,1295
2020-03-06,KS,0,4,0,0,0,4,2020-03-06T21:00:00Z,4,0,0,0,0,0
2020-03-07,KS,0,11,2,0,0,13,2020-03-07T21:00:00Z,11,0,0,7,0,7
2020-03-08,KS,1,11,0,0,0,12,2020-03-08T20:00:00Z,12,0,0,0,1,1
2020-03-09,KS,1,11,0,0,0,12,2020-03-09T20:00:00Z,12,0,0,0,0,0
2020-03-10,KS,1,17,21,0,0,39,2020-03-10T20:00:00Z,18,0,0,6,0,6
2020-03-11,KS,1,41,0,0,0,42,2020-03-11T20:00:00Z,42,0,0,24,0,24
2020-03-12,KS,4,41,0,0,0,45,2020-03-12T20:00:00Z,45,0,0,0,3,3
2020-03-13,KS,6,93,0,0,0,99,2020-03-13T20:00:00Z,99,0,0,52,2,54
2020-03-14,KS,6,93,0,0,1,99,2020-03-14T20:00:00Z,99,1,0,0,0,0
2020-03-15,KS,8,135,0,0,1,143,2020-03-15T20:00:00Z,143,0,0,42,2,44
2020-03-16,KS,11,166,0,0,1,177,2020-03-16T20:00:00Z,177,0,0,31,3,34
2020-03-17,KS,15,382,0,0,1,397,2020-03-17T20:00:00Z,397,0,0,216,4,220
2020-03-18,KS,16,417,0,0,1,433,2020-03-18T20:00:00Z,433,0,0,35,1,36
2020-03-19,KS,34,417,0,0,1,451,2020-03-19T20:00:00Z,451,0,0,0,18,18
2020-03-20,KS,44,417,0,0,1,461,2020-03-20T20:00:00Z,461,0,0,0,10,10
2020-03-21,KS,55,417,0,0,2,472,2020-03-21T20:00:00Z,472,1,0,0,11,11
2020-03-22,KS,64,417,0,0,2,481,2020-03-22T20:00:00Z,481,0,0,0,9,9
2020-03-23,KS,82,417,0,0,2,499,2020-03-23T20:00:00Z,499,0,0,0,18,18
2020-03-24,KS,98,2086,0,0,2,2184,2020-03-24T20:00:00Z,2184,0,0,1669,16,1685
2020-03-25,KS,126,2360,0,0,3,2486,2020-03-25T20:00:00Z,2486,1,0,274,28,302
2020-03-26,KS,168,2869,0,0,3,3037,2020-03-26T20:00:00Z,3037,0,0,509,42,551
2020-03-06,KY,0,7,3,0,0,10,2020-03-06T21:00:00Z,7,0,0,0,0,0
2020-03-07,KY,1,9,0,0,0,10,2020-03-07T21:00:00Z,10,0,0,2,1,3
2020-03-08,KY,1,13,0,0,0,14,2020-03-08T20:00:00Z,14,0,0,4,0,4
2020-03-09,KY,4,17,0,0,0,21,2020-03-09T20:00:00Z,21,0,0,4,3,7
2020-03-10,KY,6,28,0,0,0,34,2020-03-10T20:00:00Z,34,0,0,11,2,13
2020-03-11,KY,8,46,0,0,0,54,2020-03-11T20:00:00Z,54,0,0,18,2,20
2020-03-12,KY,8,56,0,0,0,64,2020-03-12T20:00:00Z,64,0,0,10,0,10
2020-03-13,KY,11,107,0,0,0,118,2020-03-13T20:00:00Z,118,0,0,51,3,54
2020-03-14,KY,14,139,0,0,0,153,2020-03-14T20:00:00Z,153,0,0,32,3,35
2020-03-15,KY,16,139,0,0,0,155,2020-03-15T20:00:00Z,155,0,0,0,2,2
2020-03-16,KY,21,234,0,0,1,255,2020-03-16T20:00:00Z,255,1,0,95,5,100
2020-03-17,KY,22,295,0,0,1,317,2020-03-17T20:00:00Z,317,0,0,61,1,62
2020-03-18,KY,26,354,0,0,1,380,2020-03-18T20:00:00Z,380,0,0,59,4,63
2020-03-19,KY,35,454,0,0,1,489,2020-03-19T20:00:00Z,489,0,0,100,9,109
2020-03-20,KY,47,592,0,0,1,639,2020-03-20T20:00:00Z,639,0,0,138,12,150
2020-03-21,KY,54,714,0,0,2,768,2020-03-21T20:00:00Z,768,1,0,122,7,129
2020-03-22,KY,99,1472,0,0,3,1571,2020-03-22T20:00:00Z,1571,1,0,758,45,803
2020-03-23,KY,104,1762,0,0,3,1866,2020-03-23T20:00:00Z,1866,0,0,290,5,295
2020-03-24,KY,124,1742,0,0,4,1866,2020-03-24T20:00:00Z,1866,1,0,-20,20,0
2020-03-25,KY,157,2865,0,0,4,3022,2020-03-25T20:00:00Z,3022,0,0,1123,33,1156
2020-03-26,KY,198,3102,0,0,4,3300,2020-03-26T20:00:00Z,3300,0,0,237,41,278
2020-03-07,LA,0,0,0,0,0,0,2020-03-07T21:00:00Z,0,0,0,0,0,0
2020-03-08,LA,0,5,0,0,0,5,2020-03-08T20:00:00Z,5,0,0,5,0,5
2020-03-09,LA,1,5,0,0,0,6,2020-03-09T20:00:00Z,6,0,0,0,1,1
2020-03-10,LA,1,11,0,0,0,12,2020-03-10T20:00:00Z,12,0,0,6,0,6
2020-03-11,LA,6,37,0,0,0,43,2020-03-11T20:00:00Z,43,0,0,26,5,31
2020-03-12,LA,14,37,0,0,0,51,2020-03-12T20:00:00Z,51,0,0,0,8,8
2020-03-13,LA,36,37,0,0,0,73,2020-03-13T20:00:00Z,73,0,0,0,22,22
2020-03-14,LA,69,109,0,0,0,178,2020-03-14T20:00:00Z,178,0,0,72,33,105
2020-03-15,LA,91,156,0,0,2,247,2020-03-15T20:00:00Z,247,2,0,47,22,69
2020-03-16,LA,114,188,0,0,2,302,2020-03-16T20:00:00Z,302,0,0,32,23,55
2020-03-17,LA,171,286,0,0,4,457,2020-03-17T20:00:00Z,457,2,0,98,57,155
2020-03-18,LA,240,335,0,0,6,575,2020-03-18T20:00:00Z,575,2,0,49,69,118
2020-03-19,LA,347,458,0,0,8,805,2020-03-19T20:00:00Z,805,2,0,123,107,230
2020-03-20,LA,479,568,0,0,12,1047,2020-03-20T20:00:00Z,1047,4,0,110,132,242
2020-03-21,LA,585,2180,0,0,16,2765,2020-03-21T20:00:00Z,2765,4,0,1612,106,1718
2020-03-22,LA,837,2661,0,0,20,3498,2020-03-22T20:00:00Z,3498,4,0,481,252,733
2020-03-23,LA,1172,4776,0,0,34,5948,2020-03-23T20:00:00Z,5948,14,0,2115,335,2450
2020-03-24,LA,1388,7215,0,271,46,8603,2020-03-24T20:00:00Z,8603,12,271,2439,216,2655
2020-03-25,LA,1795,9656,0,491,65,11451,2020-03-25T20:00:00Z,11451,19,220,2441,407,2848
2020-03-26,LA,2305,15724,0,676,83,18029,2020-03-26T20:00:00Z,18029,18,185,6068,510,6578
2020-03-04,MA,2,0,0,0,0,2,2020-03-04T21:00:00Z,2,0,0,0,0,0
2020-03-05,MA,2,0,0,0,0,2,2020-03-05T21:00:00Z,2,0,0,0,0,0
2020-03-06,MA,8,0,0,0,0,8,2020-03-06T21:00:00Z,8,0,0,0,6,6
2020-03-07,MA,13,0,0,0,0,13,2020-03-07T21:00:00Z,13,0,0,0,5,5
2020-03-08,MA,13,0,0,0,0,13,2020-03-08T20:00:00Z,13,0,0,0,0,0
2020-03-09,MA,41,0,0,0,0,41,2020-03-09T20:00:00Z,41,0,0,0,28,28
2020-03-10,MA,92,0,0,0,0,92,2020-03-10T20:00:00Z,92,0,0,0,51,51
2020-03-11,MA,92,0,0,0,0,92,2020-03-11T20:00:00Z,92,0,0,0,0,0
2020-03-12,MA,95,0,0,0,0,95,2020-03-12T20:00:00Z,95,0,0,0,3,3
2020-03-13,MA,123,92,0,0,0,215,2020-03-13T20:00:00Z,215,0,0,92,28,120
2020-03-14,MA,138,352,0,0,0,490,2020-03-14T20:00:00Z,490,0,0,260,15,275
2020-03-15,MA,138,352,0,0,0,490,2020-03-15T20:00:00Z,490,0,0,0,0,0
2020-03-16,MA,164,352,0,0,0,516,2020-03-16T20:00:00Z,516,0,0,0,26,26
2020-03-17,MA,218,1541,0,0,0,1759,2020-03-17T20:00:00Z,1759,0,0,1189,54,1243
2020-03-18,MA,256,2015,0,0,0,2271,2020-03-18T20:00:00Z,2271,0,0,474,38,512
2020-03-19,MA,328,2804,0,0,0,3132,2020-03-19T20:00:00Z,3132,0,0,789,72,861
2020-03-20,MA,413,3678,0,0,1,4091,2020-03-20T20:00:00Z,4091,1,0,874,85,959
2020-03-21,MA,525,4752,0,61,1,5277,2020-03-21T20:00:00Z,5277,0,61,1074,112,1186
2020-03-22,MA,646,5459,0,71,5,6105,2020-03-22T20:00:00Z,6105,4,10,707,121,828
2020-03-23,MA,777,8145,0,79,9,8922,2020-03-23T20:00:00Z,8922,4,8,2686,131,2817
2020-03-24,MA,1159,12590,0,94,11,13749,2020-03-24T20:00:00Z,13749,2,15,4445,382,4827
2020-03-25,MA,1838,17956,0,103,15,19794,2020-03-25T20:00:00Z,19794,4,9,5366,679,6045
2020-03-26,MA,2417,21204,0,219,25,23621,2020-03-26T20:00:00Z,23621,10,116,3248,579,3827
2020-03-05,MD,0,17,14,0,0,31,2020-03-05T21:00:00Z,17,0,0,0,0,0
2020-03-06,MD,3,26,12,0,0,41,2020-03-06T21:00:00Z,29,0,0,9,3,12
2020-03-07,MD,3,41,0,0,0,44,2020-03-07T21:00:00Z,44,0,0,15,0,15
2020-03-08,MD,3,52,0,0,0,55,2020-03-08T20:00:00Z,55,0,0,11,0,11
2020-03-09,MD,5,73,0,0,0,78,2020-03-09T20:00:00Z,78,0,0,21,2,23
2020-03-10,MD,6,89,0,0,0,95,2020-03-10T20:00:00Z,95,0,0,16,1,17
2020-03-11,MD,9,94,0,0,0,103,2020-03-11T20:00:00Z,103,0,0,5,3,8
2020-03-12,MD,12,94,0,0,0,106,2020-03-12T20:00:00Z,106,0,0,0,3,3
2020-03-13,MD,17,94,0,0,0,111,2020-03-13T20:00:00Z,111,0,0,0,5,5
2020-03-14,MD,26,94,0,0,0,120,2020-03-14T20:00:00Z,120,0,0,0,9,9
2020-03-15,MD,31,94,0,0,0,125,2020-03-15T20:00:00Z,125,0,0,0,5,5
2020-03-16,MD,37,94,0,0,0,131,2020-03-16T20:00:00Z,131,0,0,0,6,6
2020-03-17,MD,57,94,0,0,0,151,2020-03-17T20:00:00Z,151,0,0,0,20,20
2020-03-18,MD,85,94,0,0,0,179,2020-03-18T20:00:00Z,179,0,0,0,28,28
2020-03-19,MD,107,94,0,0,1,201,2020-03-19T20:00:00Z,201,1,0,0,22,22
2020-03-20,MD,149,94,0,0,1,243,2020-03-20T20:00:00Z,243,0,0,0,42,42
2020-03-21,MD,190,94,0,0,2,284,2020-03-21T20:00:00Z,284,1,0,0,41,41
2020-03-22,MD,244,94,0,0,3,338,2020-03-22T20:00:00Z,338,1,0,0,54,54
2020-03-23,MD,288,94,0,0,3,382,2020-03-23T20:00:00Z,382,0,0,0,44,44
2020-03-24,MD,349,94,0,0,3,443,2020-03-24T20:00:00Z,443,0,0,0,61,61
2020-03-25,MD,423,94,0,0,4,517,2020-03-25T20:00:00Z,517,1,0,0,74,74
2020-03-26,MD,580,94,0,132,4,674,2020-03-26T20:00:00Z,674,0,132,0,157,157
2020-03-07,ME,0,1,0,0,0,1,2020-03-07T21:00:00Z,1,0,0,0,0,0
2020-03-08,ME,0,1,0,0,0,1,2020-03-08T20:00:00Z,1,0,0,0,0,0
2020-03-09,ME,0,1,0,0,0,1,2020-03-09T20:00:00Z,1,0,0,0,0,0
2020-03-10,ME,0,20,5,0,0,25,2020-03-10T20:00:00Z,20,0,0,19,0,19
2020-03-11,ME,0,42,5,0,0,47,2020-03-11T20:00:00Z,42,0,0,22,0,22
2020-03-12,ME,1,65,20,0,0,86,2020-03-12T20:00:00Z,66,0,0,23,1,24
2020-03-13,ME,3,91,17,0,0,111,2020-03-13T20:00:00Z,94,0,0,26,2,28
2020-03-14,ME,3,91,17,0,0,111,2020-03-14T20:00:00Z,94,0,0,0,0,0
2020-03-15,ME,3,91,17,0,0,111,2020-03-15T20:00:00Z,94,0,0,0,0,0
2020-03-16,ME,17,764,0,0,0,781,2020-03-16T20:00:00Z,781,0,0,673,14,687
2020-03-17,ME,32,1303,0,0,0,1335,2020-03-17T20:00:00Z,1335,0,0,539,15,554
2020-03-18,ME,43,1670,0,0,0,1713,2020-03-18T20:00:00Z,1713,0,0,367,11,378
2020-03-19,ME,53,2004,0,0,0,2057,2020-03-19T20:00:00Z,2057,0,0,334,10,344
2020-03-20,ME,57,2264,0,0,0,2321,2020-03-20T20:00:00Z,2321,0,0,260,4,264
2020-03-21,ME,73,2264,0,0,0,2337,2020-03-21T20:00:00Z,2337,0,0,0,16,16
2020-03-22,ME,89,2264,0,0,0,2353,2020-03-22T20:00:00Z,2353,0,0,0,16,16
2020-03-23,ME,107,2791,0,0,0,2898,2020-03-23T20:00:00Z,2898,0,0,527,18,545
2020-03-24,ME,125,3014,0,0,0,3139,2020-03-24T20:00:00Z,3139,0,0,223,18,241
2020-03-25,ME,149,3177,0,0,0,3326,2020-03-25T20:00:00Z,3326,0,0,163,24,187
2020-03-26,ME,155,3394,0,0,0,3549,2020-03-26T20:00:00Z,3549,0,0,217,6,223
2020-03-05,MI,0,8,0,0,0,8,2020-03-05T21:00:00Z,8,0,0,0,0,0
2020-03-06,MI,0,8,8,0,0,16,2020-03-06T21:00:00Z,8,0,0,0,0,0
2020-03-07,MI,0,18,9,0,0,27,2020-03-07T21:00:00Z,18,0,0,10,0,10
2020-03-08,MI,0,26,10,0,0,36,2020-03-08T20:00:00Z,26,0,0,8,0,8
2020-03-09,MI,0,36,11,0,0,47,2020-03-09T20:00:00Z,36,0,0,10,0,10
2020-03-10,MI,0,39,24,0,0,63,2020-03-10T20:00:00Z,39,0,0,3,0,3
2020-03-11,MI,2,57,18,0,0,77,2020-03-11T20:00:00Z,59,0,0,18,2,20
2020-03-12,MI,2,91,27,0,0,120,2020-03-12T20:00:00Z,93,0,0,34,0,34
2020-03-13,MI,16,133,26,0,0,175,2020-03-13T20:00:00Z,149,0,0,42,14,56
2020-03-14,MI,25,205,26,0,0,256,2020-03-14T20:00:00Z,230,0,0,72,9,81
2020-03-15,MI,33,205,26,0,0,264,2020-03-15T20:00:00Z,238,0,0,0,8,8
2020-03-16,MI,53,272,30,0,0,355,2020-03-16T20:00:00Z,325,0,0,67,20,87
2020-03-17,MI,65,272,0,0,0,337,2020-03-17T20:00:00Z,337,0,0,0,12,12
2020-03-18,MI,80,272,0,0,0,352,2020-03-18T20:00:00Z,352,0,0,0,15,15
2020-03-19,MI,336,2113,0,0,3,2449,2020-03-19T20:00:00Z,2449,3,0,1841,256,2097
2020-03-20,MI,549,2069,0,0,3,2618,2020-03-20T20:00:00Z,2618,0,0,-44,213,169
2020-03-21,MI,787,2069,0,0,5,2856,2020-03-21T20:00:00Z,2856,2,0,0,238,238
2020-03-22,MI,1035,2069,0,0,8,3104,2020-03-22T20:00:00Z,3104,3,0,0,248,248
2020-03-23,MI,1328,2069,0,0,15,3397,2020-03-23T20:00:00Z,3397,7,0,0,293,293
2020-03-24,MI,1791,2069,0,0,24,3860,2020-03-24T20:00:00Z,3860,9,0,0,463,463
2020-03-25,MI,2294,2069,0,0,43,4363,2020-03-25T20:00:00Z,4363,19,0,0,503,503
2020-03-26,MI,2856,6550,0,0,60,9406,2020-03-26T20:00:00Z,9406,17,0,4481,562,5043
2020-03-06,MN,0,36,0,0,0,36,2020-03-06T21:00:00Z,36,0,0,0,0,0
2020-03-07,MN,1,48,0,0,0,49,2020-03-07T21:00:00Z,49,0,0,12,1,13
2020-03-08,MN,1,48,0,0,0,49,2020-03-08T20:00:00Z,49,0,0,0,0,0
2020-03-09,MN,2,80,0,0,0,82,2020-03-09T20:00:00Z,82,0,0,32,1,33
2020-03-10,MN,3,132,0,0,0,135,2020-03-10T20:00:00Z,135,0,0,52,1,53
2020-03-11,MN,5,217,0,0,0,222,2020-03-11T20:00:00Z,222,0,0,85,2,87
2020-03-12,MN,9,307,0,0,0,316,2020-03-12T20:00:00Z,316,0,0,90,4,94
2020-03-13,MN,14,541,0,0,0,555,2020-03-13T20:00:00Z,555,0,0,234,5,239
2020-03-14,MN,21,847,0,0,0,868,2020-03-14T20:00:00Z,868,0,0,306,7,313
2020-03-15,MN,35,1387,0,0,0,1422,2020-03-15T20:00:00Z,1422,0,0,540,14,554
2020-03-16,MN,54,1839,0,0,0,1893,2020-03-16T20:00:00Z,1893,0,0,452,19,471
2020-03-17,MN,60,2276,0,0,0,2336,2020-03-17T20:00:00Z,2336,0,0,437,6,443
2020-03-18,MN,77,2685,0,0,0,2762,2020-03-18T20:00:00Z,2762,0,0,409,17,426
2020-03-19,MN,89,2949,0,0,0,3038,2020-03-19T20:00:00Z,3038,0,0,264,12,276
2020-03-20,MN,115,3741,0,0,0,3856,2020-03-20T20:00:00Z,3856,0,0,792,26,818
2020-03-21,MN,138,3952,0,0,1,4090,2020-03-21T20:00:00Z,4090,1,0,211,23,234
2020-03-22,MN,169,4511,0,12,1,4680,2020-03-22T20:00:00Z,4680,0,12,559,31,590
2020-03-23,MN,235,4511,0,17,1,4746,2020-03-23T20:00:00Z,4746,0,5,0,66,66
2020-03-24,MN,262,5550,0,21,1,5812,2020-03-24T20:00:00Z,5812,0,4,1039,27,1066
2020-03-25,MN,287,11188,0,35,1,11475,2020-03-25T20:00:00Z,11475,0,14,5638,25,5663
2020-03-26,MN,346,12604,0,41,2,12950,2020-03-26T20:00:00Z,12950,1,6,1416,59,1475
2020-03-07,MO,0,0,0,0,0,0,2020-03-07T21:00:00Z,0,0,0,0,0,0
2020-03-08,MO,1,0,0,0,0,1,2020-03-08T20:00:00Z,1,0,0,0,1,1
2020-03-09,MO,1,0,0,0,0,1,2020-03-09T20:00:00Z,1,0,0,0,0,0
2020-03-10,MO,1,0,0,0,0,1,2020-03-10T20:00:00Z,1,0,0,0,0,0
2020-03-11,MO,1,0,0,0,0,1,2020-03-11T20:00:00Z,1,0,0,0,0,0
2020-03-12,MO,1,64,0,0,0,65,2020-03-12T20:00:00Z,65,0,0,64,0,64
2020-03-13,MO,2,71,0,0,0,73,2020-03-13T20:00:00Z,73,0,0,7,1,8
2020-03-14,MO,4,90,0,0,0,94,2020-03-14T20:00:00Z,94,0,0,19,2,21
2020-03-15,MO,5,122,0,0,0,127,2020-03-15T20:00:00Z,127,0,0,32,1,33
2020-03-16,MO,6,164,0,0,0,170,2020-03-16T20:00:00Z,170,0,0,42,1,43
2020-03-17,MO,8,207,0,0,0,215,2020-03-17T20:00:00Z,215,0,0,43,2,45
2020-03-18,MO,13,253,0,0,0,266,2020-03-18T20:00:00Z,266,0,0,46,5,51
2020-03-19,MO,24,308,0,0,1,332,2020-03-19T20:00:00Z,332,1,0,55,11,66
2020-03-20,MO,47,369,0,0,1,416,2020-03-20T20:00:00Z,416,0,0,61,23,84
2020-03-21,MO,73,369,0,0,3,442,2020-03-21T20:00:00Z,442,2,0,0,26,26
2020-03-22,MO,90,369,0,0,3,459,2020-03-22T20:00:00Z,459,0,0,0,17,17
2020-03-23,MO,183,369,0,0,3,552,2020-03-23T20:00:00Z,552,0,0,0,93,93
2020-03-24,MO,183,369,0,0,3,552,2020-03-24T20:00:00Z,552,0,0,0,0,0
2020-03-25,MO,356,369,0,0,8,725,2020-03-25T20:00:00Z,725,5,0,0,173,173
2020-03-26,MO,502,369,0,0,8,871,2020-03-26T20:00:00Z,871,0,0,0,146,146
2020-03-16,MP,0,0,0,0,0,0,2020-03-16T20:00:00Z,0,0,0,0,0,0
2020-03-17,MP,0,0,0,0,0,0,2020-03-17T20:00:00Z,0,0,0,0,0,0
2020-03-18,MP,0,0,0,0,0,0,2020-03-18T20:00:00Z,0,0,0,0,0,0
2020-03-19,MP,0,0,0,0,0,0,2020-03-19T20:00:00Z,0,0,0,0,0,0
2020-03-20,MP,0,0,0,0,0,0,2020-03-20T20:00:00Z,0,0,0,0,0,0
2020-03-21,MP,0,0,0,0,0,0,2020-03-21T20:00:00Z,0,0,0,0,0,0
2020-03-22,MP,0,0,0,0,0,0,2020-03-22T20:00:00Z,0,0,0,0,0,0
2020-03-23,MP,0,0,0,0,0,0,2020-03-23T20:00:00Z,0,0,0,0,0,0
2020-03-24,MP,0,0,0,0,0,0,2020-03-24T20:00:00Z,0,0,0,0,0,0
2020-03-25,MP,0,0,0,0,0,0,2020-03-25T20:00:00Z,0,0,0,0,0,0
2020-03-26,MP,0,0,0,0,0,0,2020-03-26T20:00:00Z,0,0,0,0,0,0
2020-03-07,MS,0,0,0,0,0,0,2020-03-07T21:00:00Z,0,0,0,0,0,0
2020-03-08,MS,0,0,0,0,0,0,2020-03-08T20:00:00Z,0,0,0,0,0,0
2020-03-09,MS,0,0,0,0,0,0,2020-03-09T20:00:00Z,0,0,0,0,0,0
2020-03-10,MS,0,0,0,0,0,0,2020-03-10T20:00:00Z,0,0,0,0,0,0
2020-03-11,MS,0,20,0,0,0,20,2020-03-11T20:00:00Z,20,0,0,20,0,20
2020-03-12,MS,1,41,0,0,0,42,2020-03-12T20:00:00Z,42,0,0,21,1,22
2020-03-13,MS,4,41,0,0,0,45,2020-03-13T20:00:00Z,45,0,0,0,3,3
2020-03-14,MS,6,84,0,0,0,90,2020-03-14T20:00:00Z,90,0,0,43,2,45
2020-03-15,MS,10,84,0,0,0,94,2020-03-15T20:00:00Z,94,0,0,0,4,4
2020-03-16,MS,12,277,0,0,0,289,2020-03-16T20:00:00Z,289,0,0,193,2,195
2020-03-17,MS,21,368,0,0,0,389,2020-03-17T20:00:00Z,389,0,0,91,9,100
2020-03-18,MS,34,479,0,0,0,513,2020-03-18T20:00:00Z,513,0,0,111,13,124
2020-03-19,MS,50,552,0,0,0,602,2020-03-19T20:00:00Z,602,0,0,73,16,89
2020-03-20,MS,80,695,0,0,1,775,2020-03-20T20:00:00Z,775,1,0,143,30,173
2020-03-21,MS,140,695,0,0,1,835,2020-03-21T20:00:00Z,835,0,0,0,60,60
2020-03-22,MS,207,1114,0,33,1,1321,2020-03-22T20:00:00Z,1321,0,33,419,67,486
2020-03-23,MS,249,1143,0,33,1,1392,2020-03-23T20:00:00Z,1392,0,0,29,42,71
2020-03-24,MS,320,1552,0,86,1,1872,2020-03-24T20:00:00Z,1872,0,53,409,71,480
2020-03-25,MS,377,1566,0,117,2,1943,2020-03-25T20:00:00Z,1943,1,31,14,57,71
2020-03-26,MS,485,2291,0,150,6,2776,2020-03-26T20:00:00Z,2776,4,33,725,108,833
2020-03-07,MT,0,11,0,0,0,11,2020-03-07T21:00:00Z,11,0,0,0,0,0
2020-03-08,MT,0,11,0,0,0,11,2020-03-08T20:00:00Z,11,0,0,0,0,0
2020-03-09,MT,0,11,0,0,0,11,2020-03-09T20:00:00Z,11,0,0,0,0,0
2020-03-10,MT,0,15,0,0,0,15,2020-03-10T20:00:00Z,15,0,0,4,0,4
2020-03-11,MT,0,21,0,0,0,21,2020-03-11T20:00:00Z,21,0,0,6,0,6
2020-03-12,MT,1,34,0,0,0,35,2020-03-12T20:00:00Z,35,0,0,13,1,14
2020-03-13,MT,1,55,0,0,0,56,2020-03-13T20:00:00Z,56,0,0,21,0,21
2020-03-14,MT,5,103,0,0,0,108,2020-03-14T20:00:00Z,108,0,0,48,4,52
2020-03-15,MT,7,103,57,0,0,167,2020-03-15T20:00:00Z,110,0,0,0,2,2
2020-03-16,MT,7,198,0,0,0,205,2020-03-16T20:00:00Z,205,0,0,95,0,95
2020-03-17,MT,8,303,0,0,0,311,2020-03-17T20:00:00Z,311,0,0,105,1,106
2020-03-18,MT,10,499,0,0,0,509,2020-03-18T20:00:00Z,509,0,0,196,2,198
2020-03-19,MT,12,761,0,0,0,773,2020-03-19T20:00:00Z,773,0,0,262,2,264
2020-03-20,MT,16,931,0,0,0,947,2020-03-20T20:00:00Z,947,0,0,170,4,174
2020-03-21,MT,20,1146,0,0,0,1166,2020-03-21T20:00:00Z,1166,0,0,215,4,219
2020-03-22,MT,31,1146,0,0,0,1177,2020-03-22T20:00:00Z,1177,0,0,0,11,11
2020-03-23,MT,34,1146,0,0,0,1180,2020-03-23T20:00:00Z,1180,0,0,0,3,3
2020-03-24,MT,46,1643,0,0,0,1689,2020-03-24T20:00:00Z,1689,0,0,497,12,509
2020-03-25,MT,53,1948,0,0,0,2001,2020-03-25T20:00:00Z,2001,0,0,305,7,312
2020-03-26,MT,71,2128,0,1,0,2199,2020-03-26T20:00:00Z,2199,0,1,180,18,198
2020-03-04,NC,1,0,0,0,0,1,2020-03-04T21:00:00Z,1,0,0,0,0,0
2020-03-05,NC,1,0,0,0,0,1,2020-03-05T21:00:00Z,1,0,0,0,0,0
2020-03-06,NC,2,0,0,0,0,2,2020-03-06T21:00:00Z,2,0,0,0,1,1
2020-03-07,NC,2,0,0,0,0,2,2020-03-07T21:00:00Z,2,0,0,0,0,0
2020-03-08,NC,2,0,0,0,0,2,2020-03-08T20:00:00Z,2,0,0,0,0,0
2020-03-09,NC,2,0,0,0,0,2,2020-03-09T20:00:00Z,2,0,0,0,0,0
2020-03-10,NC,7,0,0,0,0,7,2020-03-10T20:00:00Z,7,0,0,0,5,5
2020-03-11,NC,7,0,0,0,0,7,2020-03-11T20:00:00Z,7,0,0,0,0,0
2020-03-12,NC,12,60,0,0,0,72,2020-03-12T20:00:00Z,72,0,0,60,5,65
2020-03-13,NC,15,86,0,0,0,101,2020-03-13T20:00:00Z,101,0,0,26,3,29
2020-03-14,NC,23,137,0,0,0,160,2020-03-14T20:00:00Z,160,0,0,51,8,59
2020-03-15,NC,32,227,151,0,0,410,2020-03-15T20:00:00Z,259,0,0,90,9,99
2020-03-16,NC,33,296,151,0,0,480,2020-03-16T20:00:00Z,329,0,0,69,1,70
2020-03-17,NC,40,474,0,0,0,514,2020-03-17T20:00:00Z,514,0,0,178,7,185
2020-03-18,NC,63,1787,0,0,0,1850,2020-03-18T20:00:00Z,1850,0,0,1313,23,1336
2020-03-19,NC,97,2408,0,0,0,2505,2020-03-19T20:00:00Z,2505,0,0,621,34,655
2020-03-20,NC,137,3096,0,0,0,3233,2020-03-20T20:00:00Z,3233,0,0,688,40,728
2020-03-21,NC,184,5092,0,0,0,5276,2020-03-21T20:00:00Z,5276,0,0,1996,47,2043
2020-03-22,NC,255,6183,0,0,0,6438,2020-03-22T20:00:00Z,6438,0,0,1091,71,1162
2020-03-23,NC,297,8141,0,0,0,8438,2020-03-23T20:00:00Z,8438,0,0,1958,42,2000
2020-03-24,NC,398,8141,0,0,0,8539,2020-03-24T20:00:00Z,8539,0,0,0,101,101
2020-03-25,NC,504,9985,0,29,1,10489,2020-03-25T20:00:00Z,10489,1,29,1844,106,1950
2020-03-26,NC,636,12274,0,29,2,12910,2020-03-26T20:00:00Z,12910,1,0,2289,132,2421
2020-03-07,ND,0,0,0,0,0,0,2020-03-07T21:00:00Z,0,0,0,0,0,0
2020-03-08,ND,0,0,0,0,0,0,2020-03-08T20:00:00Z,0,0,0,0,0,0
2020-03-09,ND,0,0,0,0,0,0,2020-03-09T20:00:00Z,0,0,0,0,0,0
2020-03-10,ND,0,6,2,0,0,8,2020-03-10T20:00:00Z,6,0,0,6,0,6
2020-03-11,ND,0,7,6,0,0,13,2020-03-11T20:00:00Z,7,0,0,1,0,1
2020-03-12,ND,1,12,14,0,0,27,2020-03-12T20:00:00Z,13,0,0,5,1,6
2020-03-13,ND,1,39,12,0,0,52,2020-03-13T20:00:00Z,40,0,0,27,0,27
2020-03-14,ND,1,54,14,0,0,69,2020-03-14T20:00:00Z,55,0,0,15,0,15
2020-03-15,ND,1,95,4,0,0,100,2020-03-15T20:00:00Z,96,0,0,41,0,41
2020-03-16,ND,1,123,0,0,0,124,2020-03-16T20:00:00Z,124,0,0,28,0,28
2020-03-17,ND,3,220,0,0,0,223,2020-03-17T20:00:00Z,223,0,0,97,2,99
2020-03-18,ND,6,268,0,0,0,274,2020-03-18T20:00:00Z,274,0,0,48,3,51
2020-03-19,ND,15,493,0,0,0,508,2020-03-19T20:00:00Z,508,0,0,225,9,234
2020-03-20,ND,20,800,0,0,0,820,2020-03-20T20:00:00Z,820,0,0,307,5,312
2020-03-21,ND,28,1141,0,3,0,1169,2020-03-21T20:00:00Z,1169,0,3,341,8,349
2020-03-22,ND,28,1260,0,3,0,1288,2020-03-22T20:00:00Z,1288,0,0,119,0,119
2020-03-23,ND,30,1353,0,4,0,1383,2020-03-23T20:00:00Z,1383,0,1,93,2,95
2020-03-24,ND,34,1454,0,5,0,1488,2020-03-24T20:00:00Z,1488,0,1,101,4,105
2020-03-25,ND,39,1734,0,8,0,1773,2020-03-25T20:00:00Z,1773,0,3,280,5,285
2020-03-26,ND,52,2039,0,10,0,2091,2020-03-26T20:00:00Z,2091,0,2,305,13,318
2020-03-05,NE,0,17,5,0,0,22,2020-03-05T21:00:00Z,17,0,0,0,0,0
2020-03-06,NE,0,17,5,0,0,22,2020-03-06T21:00:00Z,17,0,0,0,0,0
2020-03-07,NE,1,17,5,0,0,23,2020-03-07T21:00:00Z,18,0,0,0,1,1
2020-03-08,NE,1,17,5,0,0,23,2020-03-08T20:00:00Z,18,0,0,0,0,0
2020-03-09,NE,3,36,9,0,0,48,2020-03-09T20:00:00Z,39,0,0,19,2,21
2020-03-10,NE,3,47,16,0,0,66,2020-03-10T20:00:00Z,50,0,0,11,0,11
2020-03-11,NE,5,47,16,0,0,68,2020-03-11T20:00:00Z,52,0,0,0,2,2
2020-03-12,NE,10,80,33,0,0,123,2020-03-12T20:00:00Z,90,0,0,33,5,38
2020-03-13,NE,13,80,33,0,0,126,2020-03-13T20:00:00Z,93,0,0,0,3,3
2020-03-14,NE,14,80,33,0,0,127,2020-03-14T20:00:00Z,94,0,0,0,1,1
2020-03-15,NE,17,80,33,0,0,130,2020-03-15T20:00:00Z,97,0,0,0,3,3
2020-03-16,NE,18,170,0,0,0,188,2020-03-16T20:00:00Z,188,0,0,90,1,91
2020-03-17,NE,21,206,0,0,0,227,2020-03-17T20:00:00Z,227,0,0,36,3,39
2020-03-18,NE,24,206,0,0,0,230,2020-03-18T20:00:00Z,230,0,0,0,3,3
2020-03-19,NE,27,240,0,0,0,267,2020-03-19T20:00:00Z,267,0,0,34,3,37
2020-03-20,NE,32,240,0,0,0,272,2020-03-20T20:00:00Z,272,0,0,0,5,5
2020-03-21,NE,38,356,0,0,0,394,2020-03-21T20:00:00Z,394,0,0,116,6,122
2020-03-22,NE,48,356,0,0,0,404,2020-03-22T20:00:00Z,404,0,0,0,10,10
2020-03-23,NE,50,356,0,0,0,406,2020-03-23T20:00:00Z,406,0,0,0,2,2
2020-03-24,NE,52,975,0,0,0,1027,2020-03-24T20:00:00Z,1027,0,0,619,2,621
2020-03-25,NE,61,1304,0,0,0,1365,2020-03-25T20:00:00Z,1365,0,0,329,9,338
2020-03-26,NE,73,1584,0,0,0,1657,2020-03-26T20:00:00Z,1657,0,0,280,12,292
2020-03-04,NH,2,10,7,0,0,19,2020-03-04T21:00:00Z,12,0,0,0,0,0
2020-03-05,NH,2,16,4,0,0,22,2020-03-05T21:00:00Z,18,0,0,6,0,6
2020-03-06,NH,2,20,3,0,0,25,2020-03-06T21:00:00Z,22,0,0,4,0,4
2020-03-07,NH,2,20,3,0,0,25,2020-03-07T21:00:00Z,22,0,0,0,0,0
2020-03-08,NH,4,38,5,0,0,47,2020-03-08T20:00:00Z,42,0,0,18,2,20
2020-03-09,NH,4,38,5,0,0,47,2020-03-09T20:00:00Z,42,0,0,0,0,0
2020-03-10,NH,4,38,5,0,0,47,2020-03-10T20:00:00Z,42,0,0,0,0,0
2020-03-11,NH,4,38,5,0,0,47,2020-03-11T20:00:00Z,42,0,0,0,0,0
2020-03-12,NH,6,94,21,0,0,121,2020-03-12T20:00:00Z,100,0,0,56,2,58
2020-03-13,NH,6,94,21,0,0,121,2020-03-13T20:00:00Z,100,0,0,0,0,0
2020-03-14,NH,7,212,31,0,0,250,2020-03-14T20:00:00Z,219,0,0,118,1,119
2020-03-15,NH,13,271,95,0,0,379,2020-03-15T20:00:00Z,284,0,0,59,6,65
2020-03-16,NH,13,271,95,0,0,379,2020-03-16T20:00:00Z,284,0,0,0,0,0
2020-03-17,NH,17,355,195,0,0,567,2020-03-17T20:00:00Z,372,0,0,84,4,88
2020-03-18,NH,26,513,208,0,0,747,2020-03-18T20:00:00Z,539,0,0,158,9,167
2020-03-19,NH,39,621,231,0,0,891,2020-03-19T20:00:00Z,660,0,0,108,13,121
2020-03-20,NH,44,745,631,0,0,1420,2020-03-20T20:00:00Z,789,0,0,124,5,129
2020-03-21,NH,55,973,942,0,0,1970,2020-03-21T20:00:00Z,1028,0,0,228,11,239
2020-03-22,NH,65,1188,959,0,0,2212,2020-03-22T20:00:00Z,1253,0,0,215,10,225
2020-03-23,NH,78,1374,889,0,0,2341,2020-03-23T20:00:00Z,1452,0,0,186,13,199
2020-03-24,NH,101,1447,869,11,1,2417,2020-03-24T20:00:00Z,1548,1,11,73,23,96
2020-03-25,NH,108,2356,804,13,1,3268,2020-03-25T20:00:00Z,2464,0,2,909,7,916
2020-03-26,NH,137,3001,712,19,1,3850,2020-03-26T20:00:00Z,3138,0,6,645,29,674
2020-03-05,NJ,1,0,0,0,0,1,2020-03-05T21:00:00Z,1,0,0,0,0,0
2020-03-06,NJ,1,0,0,0,0,1,2020-03-06T21:00:00Z,1,0,0,0,0,0
2020-03-07,NJ,4,0,1,0,0,5,2020-03-07T21:00:00Z,4,0,0,0,3,3
2020-03-08,NJ,6,31,0,0,0,37,2020-03-08T20:00:00Z,37,0,0,31,2,33
2020-03-09,NJ,11,35,14,0,0,60,2020-03-09T20:00:00Z,46,0,0,4,5,9
2020-03-10,NJ,15,44,20,0,0,79,2020-03-10T20:00:00Z,59,0,0,9,4,13
2020-03-11,NJ,24,57,20,0,1,101,2020-03-11T20:00:00Z,81,1,0,13,9,22
2020-03-12,NJ,30,74,20,0,1,124,2020-03-12T20:00:00Z,104,0,0,17,6,23
2020-03-13,NJ,50,97,80,0,1,227,2020-03-13T20:00:00Z,147,0,0,23,20,43
2020-03-14,NJ,50,97,80,0,1,227,2020-03-14T20:00:00Z,147,0,0,0,0,0
2020-03-15,NJ,98,120,34,0,2,252,2020-03-15T20:00:00Z,218,1,0,23,48,71
2020-03-16,NJ,178,120,20,0,2,318,2020-03-16T20:00:00Z,298,0,0,0,80,80
2020-03-17,NJ,267,163,55,0,3,485,2020-03-17T20:00:00Z,430,1,0,43,89,132
2020-03-18,NJ,427,190,21,0,5,638,2020-03-18T20:00:00Z,617,2,0,27,160,187
2020-03-19,NJ,742,210,74,0,9,1026,2020-03-19T20:00:00Z,952,4,0,20,315,335
2020-03-20,NJ,890,264,86,0,11,1240,2020-03-20T20:00:00Z,1154,2,0,54,148,202
2020-03-21,NJ,1327,294,40,0,16,1661,2020-03-21T20:00:00Z,1621,5,0,30,437,467
2020-03-22,NJ,1914,327,49,0,20,2290,2020-03-22T20:00:00Z,2241,4,0,33,587,620
2020-03-23,NJ,2844,359,94,0,27,3297,2020-03-23T20:00:00Z,3203,7,0,32,930,962
2020-03-24,NJ,3675,8325,45,0,44,12045,2020-03-24T20:00:00Z,12000,17,0,7966,831,8797
2020-03-25,NJ,4402,10452,0,0,62,14854,2020-03-25T20:00:00Z,14854,18,0,2127,727,2854
2020-03-26,NJ,6876,13661,0,0,81,20537,2020-03-26T20:00:00Z,20537,19,0,3209,2474,5683
2020-03-06,NM,0,16,0,0,0,16,2020-03-06T21:00:00Z,16,0,0,0,0,0
2020-03-07,NM,0,48,0,0,0,48,2020-03-07T21:00:00Z,48,0,0,32,0,32
2020-03-08,NM,0,48,0,0,0,48,2020-03-08T20:00:00Z,48,0,0,0,0,0
2020-03-09,NM,0,57,0,0,0,57,2020-03-09T20:00:00Z,57,0,0,9,0,9
2020-03-10,NM,0,69,0,0,0,69,2020-03-10T20:00:00Z,69,0,0,12,0,12
2020-03-11,NM,3,87,0,0,0,90,2020-03-11T20:00:00Z,90,0,0,18,3,21
2020-03-12,NM,5,155,0,0,0,160,2020-03-12T20:00:00Z,160,0,0,68,2,70
2020-03-13,NM,10,190,0,0,0,200,2020-03-13T20:00:00Z,200,0,0,35,5,40
2020-03-14,NM,10,237,0,0,0,247,2020-03-14T20:00:00Z,247,0,0,47,0,47
2020-03-15,NM,13,482,0,0,0,495,2020-03-15T20:00:00Z,495,0,0,245,3,248
2020-03-16,NM,17,566,0,0,0,583,2020-03-16T20:00:00Z,583,0,0,84,4,88
2020-03-17,NM,23,1249,0,0,0,1272,2020-03-17T20:00:00Z,1272,0,0,683,6,689
2020-03-18,NM,28,2326,0,0,0,2354,2020-03-18T20:00:00Z,2354,0,0,1077,5,1082
2020-03-19,NM,35,2762,0,0,0,2797,2020-03-19T20:00:00Z,2797,0,0,436,7,443
2020-03-20,NM,43,3771,0,0,0,3814,2020-03-20T20:00:00Z,3814,0,0,1009,8,1017
2020-03-21,NM,57,3771,0,0,0,3828,2020-03-21T20:00:00Z,3828,0,0,0,14,14
2020-03-22,NM,57,4722,0,0,0,4779,2020-03-22T20:00:00Z,4779,0,0,951,0,951
2020-03-23,NM,65,5321,0,0,0,5386,2020-03-23T20:00:00Z,5386,0,0,599,8,607
2020-03-24,NM,83,5890,0,0,0,5973,2020-03-24T20:00:00Z,5973,0,0,569,18,587
2020-03-25,NM,100,6742,0,0,1,6842,2020-03-25T20:00:00Z,6842,1,0,852,17,869
2020-03-26,NM,112,7681,0,0,1,7793,2020-03-26T20:00:00Z,7793,0,0,939,12,951
2020-03-05,NV,1,14,0,0,0,15,2020-03-05T21:00:00Z,15,0,0,0,0,0
2020-03-06,NV,1,14,0,0,0,15,2020-03-06T21:00:00Z,15,0,0,0,0,0
2020-03-07,NV,1,14,0,0,0,15,2020-03-07T21:00:00Z,15,0,0,0,0,0
2020-03-08,NV,1,14,0,0,0,15,2020-03-08T20:00:00Z,15,0,0,0,0,0
2020-03-09,NV,1,14,0,0,0,15,2020-03-09T20:00:00Z,15,0,0,0,0,0
2020-03-10,NV,0,14,0,0,0,14,2020-03-10T20:00:00Z,14,0,0,0,0,-1
2020-03-11,NV,5,168,0,0,0,173,2020-03-11T20:00:00Z,173,0,0,154,5,159
2020-03-12,NV,7,168,0,0,0,175,2020-03-12T20:00:00Z,175,0,0,0,2,2
2020-03-13,NV,11,168,0,0,0,179,2020-03-13T20:00:00Z,179,0,0,0,4,4
2020-03-14,NV,20,168,0,0,0,188,2020-03-14T20:00:00Z,188,0,0,0,9,9
2020-03-15,NV,21,168,164,0,0,353,2020-03-15T20:00:00Z,189,0,0,0,1,1
2020-03-16,NV,45,168,0,0,1,213,2020-03-16T20:00:00Z,213,1,0,0,24,24
2020-03-17,NV,55,168,0,0,1,223,2020-03-17T20:00:00Z,223,0,0,0,10,10
2020-03-18,NV,55,168,0,0,1,223,2020-03-18T20:00:00Z,223,0,0,0,0,0
2020-03-19,NV,95,1626,0,0,1,1721,2020-03-19T20:00:00Z,1721,0,0,1458,40,1498
2020-03-20,NV,109,1992,-3,0,1,2098,2020-03-20T20:00:00Z,2101,0,0,366,14,380
2020-03-21,NV,124,2384,0,0,2,2508,2020-03-21T20:00:00Z,2508,1,0,392,15,407
2020-03-22,NV,190,2448,0,0,2,2638,2020-03-22T20:00:00Z,2638,0,0,64,66,130
2020-03-23,NV,245,3490,0,0,4,3735,2020-03-23T20:00:00Z,3735,2,0,1042,55,1097
2020-03-24,NV,278,3954,0,0,4,4232,2020-03-24T20:00:00Z,4232,0,0,464,33,497
2020-03-25,NV,321,4251,0,0,6,4572,2020-03-25T20:00:00Z,4572,2,0,297,43,340
2020-03-26,NV,420,4697,0,0,10,5117,2020-03-26T20:00:00Z,5117,4,0,446,99,545
2020-03-04,NY,6,48,24,0,0,78,2020-03-04T21:00:00Z,54,0,0,0,0,0
2020-03-05,NY,22,76,24,0,0,122,2020-03-05T21:00:00Z,98,0,0,28,16,44
2020-03-06,NY,33,92,236,0,0,361,2020-03-06T21:00:00Z,125,0,0,16,11,27
2020-03-07,NY,76,92,236,0,0,404,2020-03-07T21:00:00Z,168,0,0,0,43,43
2020-03-08,NY,105,92,0,0,0,197,2020-03-08T20:00:00Z,197,0,0,0,29,29
2020-03-09,NY,142,92,0,0,0,234,2020-03-09T20:00:00Z,234,0,0,0,37,37
2020-03-10,NY,173,92,0,0,0,265,2020-03-10T20:00:00Z,265,0,0,0,31,31
2020-03-11,NY,216,92,0,0,0,308,2020-03-11T20:00:00Z,308,0,0,0,43,43
2020-03-12,NY,216,92,0,0,0,308,2020-03-12T20:00:00Z,308,0,0,0,0,0
2020-03-13,NY,421,2779,0,0,0,3200,2020-03-13T20:00:00Z,3200,0,0,2687,205,2892
2020-03-14,NY,524,2779,0,0,0,3303,2020-03-14T20:00:00Z,3303,0,0,0,103,103
2020-03-15,NY,729,4543,0,0,3,5272,2020-03-15T20:00:00Z,5272,3,0,1764,205,1969
2020-03-16,NY,950,4543,0,0,7,5493,2020-03-16T20:00:00Z,5493,4,0,0,221,221
2020-03-17,NY,1700,5506,0,0,7,7206,2020-03-17T20:00:00Z,7206,0,0,963,750,1713
2020-03-18,NY,2382,12215,0,0,12,14597,2020-03-18T20:00:00Z,14597,5,0,6709,682,7391
2020-03-19,NY,4152,18132,0,0,12,22284,2020-03-19T20:00:00Z,22284,0,0,5917,1770,7687
2020-03-20,NY,7102,25325,0,0,35,32427,2020-03-20T20:00:00Z,32427,23,0,7193,2950,10143
2020-03-21,NY,10356,35081,0,1603,44,45437,2020-03-21T20:00:00Z,45437,9,1603,9756,3254,13010
2020-03-22,NY,15168,46233,0,1974,114,61401,2020-03-22T20:00:00Z,61401,70,371,11152,4812,15964
2020-03-23,NY,20875,57414,0,2635,114,78289,2020-03-23T20:00:00Z,78289,0,661,11181,5707,16888
2020-03-24,NY,25665,65605,0,3234,210,91270,2020-03-24T20:00:00Z,91270,96,599,8191,4790,12981
2020-03-25,NY,30811,72668,0,3805,285,103479,2020-03-25T20:00:00Z,103479,75,571,7063,5146,12209
2020-03-26,NY,37258,84846,0,6844,385,122104,2020-03-26T20:00:00Z,122104,100,3039,12178,6447,18625
2020-03-05,OH,0,7,3,0,0,10,2020-03-05T21:00:00Z,7,0,0,0,0,0
2020-03-06,OH,0,8,2,0,0,10,2020-03-06T21:00:00Z,8,0,0,1,0,1
2020-03-07,OH,0,9,5,0,0,14,2020-03-07T21:00:00Z,9,0,0,1,0,1
2020-03-08,OH,0,10,4,0,0,14,2020-03-08T20:00:00Z,10,0,0,1,0,1
2020-03-09,OH,3,11,5,0,0,19,2020-03-09T20:00:00Z,14,0,0,1,3,4
2020-03-10,OH,3,14,15,0,0,32,2020-03-10T20:00:00Z,17,0,0,3,0,3
2020-03-11,OH,4,21,24,0,0,49,2020-03-11T20:00:00Z,25,0,0,7,1,8
2020-03-12,OH,5,30,52,0,0,87,2020-03-12T20:00:00Z,35,0,0,9,1,10
2020-03-13,OH,13,50,159,0,0,222,2020-03-13T20:00:00Z,63,0,0,20,8,28
2020-03-14,OH,13,50,159,0,0,222,2020-03-14T20:00:00Z,63,0,0,0,0,0
2020-03-15,OH,36,139,350,0,0,525,2020-03-15T20:00:00Z,175,0,0,89,23,112
2020-03-16,OH,50,140,361,0,0,551,2020-03-16T20:00:00Z,190,0,0,1,14,15
2020-03-17,OH,67,140,0,0,0,207,2020-03-17T20:00:00Z,207,0,0,0,17,17
2020-03-18,OH,88,140,0,0,0,228,2020-03-18T20:00:00Z,228,0,0,0,21,21
2020-03-19,OH,119,140,0,0,0,259,2020-03-19T20:00:00Z,259,0,0,0,31,31
2020-03-20,OH,169,140,0,0,1,309,2020-03-20T20:00:00Z,309,1,0,0,50,50
2020-03-21,OH,247,140,0,58,3,387,2020-03-21T20:00:00Z,387,2,58,0,78,78
2020-03-22,OH,351,140,0,83,3,491,2020-03-22T20:00:00Z,491,0,25,0,104,104
2020-03-23,OH,442,140,0,104,6,582,2020-03-23T20:00:00Z,582,3,21,0,91,91
2020-03-24,OH,564,140,0,145,8,704,2020-03-24T20:00:00Z,704,2,41,0,122,122
2020-03-25,OH,704,14060,0,182,10,14764,2020-03-25T20:00:00Z,14764,2,37,13920,140,14060
2020-03-26,OH,867,16449,0,223,15,17316,2020-03-26T20:00:00Z,17316,5,41,2389,163,2552
2020-03-07,OK,1,0,0,0,0,1,2020-03-07T21:00:00Z,1,0,0,0,0,0
2020-03-08,OK,1,8,2,0,0,11,2020-03-08T20:00:00Z,9,0,0,8,0,8
2020-03-09,OK,1,8,10,0,0,19,2020-03-09T20:00:00Z,9,0,0,0,0,0
2020-03-10,OK,2,15,11,0,0,28,2020-03-10T20:00:00Z,17,0,0,7,1,8
2020-03-11,OK,2,15,11,0,0,28,2020-03-11T20:00:00Z,17,0,0,0,0,0
2020-03-12,OK,3,36,4,0,0,43,2020-03-12T20:00:00Z,39,0,0,21,1,22
2020-03-13,OK,3,36,37,0,0,76,2020-03-13T20:00:00Z,39,0,0,0,0,0
2020-03-14,OK,4,36,37,0,0,77,2020-03-14T20:00:00Z,40,0,0,0,1,1
2020-03-15,OK,9,118,12,0,0,139,2020-03-15T20:00:00Z,127,0,0,82,5,87
2020-03-16,OK,10,174,29,0,0,213,2020-03-16T20:00:00Z,184,0,0,56,1,57
2020-03-17,OK,17,247,82,0,0,346,2020-03-17T20:00:00Z,264,0,0,73,7,80
2020-03-18,OK,29,378,110,0,0,517,2020-03-18T20:00:00Z,407,0,0,131,12,143
2020-03-19,OK,44,466,250,0,1,760,2020-03-19T20:00:00Z,510,1,0,88,15,103
2020-03-20,OK,49,538,374,0,1,961,2020-03-20T20:00:00Z,587,0,0,72,5,77
2020-03-21,OK,53,560,144,10,1,757,2020-03-21T20:00:00Z,613,0,10,22,4,26
2020-03-22,OK,67,669,102,11,2,838,2020-03-22T20:00:00Z,736,1,1,109,14,123
2020-03-23,OK,81,694,102,15,2,877,2020-03-23T20:00:00Z,775,0,4,25,14,39
2020-03-24,OK,106,735,0,25,3,841,2020-03-24T20:00:00Z,841,1,10,41,25,66
2020-03-25,OK,164,805,0,59,5,969,2020-03-25T20:00:00Z,969,2,34,70,58,128
2020-03-26,OK,248,958,0,86,7,1206,2020-03-26T20:00:00Z,1206,2,27,153,84,237
2020-03-04,OR,3,29,18,0,0,50,2020-03-04T21:00:00Z,32,0,0,0,0,0
2020-03-05,OR,3,45,13,0,0,61,2020-03-05T21:00:00Z,48,0,0,16,0,16
2020-03-06,OR,3,64,28,0,0,95,2020-03-06T21:00:00Z,67,0,0,19,0,19
2020-03-07,OR,7,77,40,0,0,124,2020-03-07T21:00:00Z,84,0,0,13,4,17
2020-03-08,OR,14,100,53,0,0,167,2020-03-08T20:00:00Z,114,0,0,23,7,30
2020-03-09,OR,14,165,52,0,0,231,2020-03-09T20:00:00Z,179,0,0,65,0,65
2020-03-10,OR,15,213,67,0,0,295,2020-03-10T20:00:00Z,228,0,0,48,1,49
2020-03-11,OR,19,286,62,0,0,367,2020-03-11T20:00:00Z,305,0,0,73,4,77
2020-03-12,OR,19,286,62,0,0,367,2020-03-12T20:00:00Z,305,0,0,0,0,0
2020-03-13,OR,30,337,157,0,0,524,2020-03-13T20:00:00Z,367,0,0,51,11,62
2020-03-14,OR,30,337,157,0,0,524,2020-03-14T20:00:00Z,367,0,0,0,0,0
2020-03-15,OR,36,420,225,0,0,681,2020-03-15T20:00:00Z,456,0,0,83,6,89
2020-03-16,OR,39,579,182,0,0,800,2020-03-16T20:00:00Z,618,0,0,159,3,162
2020-03-17,OR,47,689,184,0,0,920,2020-03-17T20:00:00Z,736,0,0,110,8,118
2020-03-18,OR,75,1118,361,0,3,1554,2020-03-18T20:00:00Z,1193,3,0,429,28,457
2020-03-19,OR,88,1329,437,0,3,1854,2020-03-19T20:00:00Z,1417,0,0,211,13,224
2020-03-20,OR,114,2003,433,0,3,2550,2020-03-20T20:00:00Z,2117,0,0,674,26,700
2020-03-21,OR,114,2003,433,0,3,2550,2020-03-21T20:00:00Z,2117,0,0,0,0,0
2020-03-22,OR,161,2864,0,43,4,3025,2020-03-22T20:00:00Z,3025,1,43,861,47,908
2020-03-23,OR,191,3649,0,56,5,3840,2020-03-23T20:00:00Z,3840,1,13,785,30,815
2020-03-24,OR,209,4350,0,61,8,4559,2020-03-24T20:00:00Z,4559,3,5,701,18,719
2020-03-25,OR,209,4350,0,61,8,4559,2020-03-25T20:00:00Z,4559,0,0,0,0,0
2020-03-26,OR,327,6953,0,90,11,7280,2020-03-26T20:00:00Z,7280,3,29,2603,118,2721
2020-03-06,PA,2,0,0,0,0,2,2020-03-06T21:00:00Z,2,0,0,0,0,0
2020-03-07,PA,2,0,0,0,0,2,2020-03-07T21:00:00Z,2,0,0,0,0,0
2020-03-08,PA,4,0,0,0,0,4,2020-03-08T20:00:00Z,4,0,0,0,2,2
2020-03-09,PA,7,0,0,0,0,7,2020-03-09T20:00:00Z,7,0,0,0,3,3
2020-03-10,PA,12,0,0,0,0,12,2020-03-10T20:00:00Z,12,0,0,0,5,5
2020-03-11,PA,15,88,54,0,0,157,2020-03-11T20:00:00Z,103,0,0,88,3,91
2020-03-12,PA,22,116,81,0,0,219,2020-03-12T20:00:00Z,138,0,0,28,7,35
2020-03-13,PA,33,140,130,0,0,303,2020-03-13T20:00:00Z,173,0,0,24,11,35
2020-03-14,PA,47,205,150,0,0,402,2020-03-14T20:00:00Z,252,0,0,65,14,79
2020-03-15,PA,63,205,183,0,0,451,2020-03-15T20:00:00Z,268,0,0,0,16,16
2020-03-16,PA,76,670,0,0,0,746,2020-03-16T20:00:00Z,746,0,0,465,13,478
2020-03-17,PA,96,879,0,0,0,975,2020-03-17T20:00:00Z,975,0,0,209,20,229
2020-03-18,PA,133,1187,0,0,0,1320,2020-03-18T20:00:00Z,1320,0,0,308,37,345
2020-03-19,PA,185,1608,0,0,1,1793,2020-03-19T20:00:00Z,1793,1,0,421,52,473
2020-03-20,PA,268,2574,0,0,1,2842,2020-03-20T20:00:00Z,2842,0,0,966,83,1049
2020-03-21,PA,371,3766,0,0,2,4137,2020-03-21T20:00:00Z,4137,1,0,1192,103,1295
2020-03-22,PA,479,4964,0,0,2,5443,2020-03-22T20:00:00Z,5443,0,0,1198,108,1306
2020-03-23,PA,644,6595,0,0,6,7239,2020-03-23T20:00:00Z,7239,4,0,1631,165,1796
2020-03-24,PA,851,8643,0,0,7,9494,2020-03-24T20:00:00Z,9494,1,0,2048,207,2255
2020-03-25,PA,1127,11193,0,0,11,12320,2020-03-25T20:00:00Z,12320,4,0,2550,276,2826
2020-03-26,PA,1687,16441,0,0,16,18128,2020-03-26T20:00:00Z,18128,5,0,5248,560,5808
2020-03-16,PR,5,9,0,0,0,14,2020-03-16T20:00:00Z,14,0,0,0,0,0
2020-03-17,PR,5,13,4,0,0,22,2020-03-17T20:00:00Z,18,0,0,4,0,4
2020-03-18,PR,5,31,21,0,0,57,2020-03-18T20:00:00Z,36,0,0,18,0,18
2020-03-19,PR,5,56,29,0,0,90,2020-03-19T20:00:00Z,61,0,0,25,0,25
2020-03-20,PR,14,114,52,0,0,180,2020-03-20T20:00:00Z,128,0,0,58,9,67
2020-03-21,PR,21,143,71,0,0,235,2020-03-21T20:00:00Z,164,0,0,29,7,36
2020-03-22,PR,23,183,69,0,0,275,2020-03-22T20:00:00Z,206,0,0,40,2,42
2020-03-23,PR,31,189,35,0,2,255,2020-03-23T20:00:00Z,220,2,0,6,8,14
2020-03-24,PR,39,268,42,0,2,349,2020-03-24T20:00:00Z,307,0,0,79,8,87
2020-03-25,PR,51,317,70,0,2,438,2020-03-25T20:00:00Z,368,0,0,49,12,61
2020-03-26,PR,64,377,335,0,2,776,2020-03-26T20:00:00Z,441,0,0,60,13,73
2020-03-07,RI,2,0,0,0,0,2,2020-03-07T21:00:00Z,2,0,0,0,0,0
2020-03-08,RI,3,30,12,0,0,45,2020-03-08T20:00:00Z,33,0,0,30,1,31
2020-03-09,RI,3,53,6,0,0,62,2020-03-09T20:00:00Z,56,0,0,23,0,23
2020-03-10,RI,3,53,6,0,0,62,2020-03-10T20:00:00Z,56,0,0,0,0,0
2020-03-11,RI,5,58,24,0,0,87,2020-03-11T20:00:00Z,63,0,0,5,2,7
2020-03-12,RI,5,94,8,0,0,107,2020-03-12T20:00:00Z,99,0,0,36,0,36
2020-03-13,RI,14,142,29,0,0,185,2020-03-13T20:00:00Z,156,0,0,48,9,57
2020-03-14,RI,20,198,57,0,0,275,2020-03-14T20:00:00Z,218,0,0,56,6,62
2020-03-15,RI,20,198,57,0,0,275,2020-03-15T20:00:00Z,218,0,0,0,0,0
2020-03-16,RI,21,308,149,0,0,478,2020-03-16T20:00:00Z,329,0,0,110,1,111
2020-03-17,RI,21,308,149,0,0,478,2020-03-17T20:00:00Z,329,0,0,0,0,0
2020-03-18,RI,33,540,334,0,0,907,2020-03-18T20:00:00Z,573,0,0,232,12,244
2020-03-19,RI,33,540,334,0,0,907,2020-03-19T20:00:00Z,573,0,0,0,0,0
2020-03-20,RI,54,654,140,0,0,848,2020-03-20T20:00:00Z,708,0,0,114,21,135
2020-03-21,RI,66,862,290,0,0,1218,2020-03-21T20:00:00Z,928,0,0,208,12,220
2020-03-22,RI,83,932,216,0,0,1231,2020-03-22T20:00:00Z,1015,0,0,70,17,87
2020-03-23,RI,106,932,216,0,0,1254,2020-03-23T20:00:00Z,1038,0,0,0,23,23
2020-03-24,RI,106,1120,77,0,0,1303,2020-03-24T20:00:00Z,1226,0,0,188,0,188
2020-03-25,RI,124,1143,196,16,0,1463,2020-03-25T20:00:00Z,1267,0,16,23,18,41
2020-03-26,RI,165,1339,181,23,0,1685,2020-03-26T20:00:00Z,1504,0,7,196,41,237
2020-03-04,SC,0,5,0,0,0,5,2020-03-04T21:00:00Z,5,0,0,0,0,0
2020-03-05,SC,0,5,0,0,0,5,2020-03-05T21:00:00Z,5,0,0,0,0,0
2020-03-06,SC,0,5,0,0,0,5,2020-03-06T21:00:00Z,5,0,0,0,0,0
2020-03-07,SC,2,8,0,0,0,10,2020-03-07T21:00:00Z,10,0,0,3,2,5
2020-03-08,SC,2,8,0,0,0,10,2020-03-08T20:00:00Z,10,0,0,0,0,0
2020-03-09,SC,7,24,0,0,0,31,2020-03-09T20:00:00Z,31,0,0,16,5,21
2020-03-10,SC,7,24,0,0,0,31,2020-03-10T20:00:00Z,31,0,0,0,0,0
2020-03-11,SC,9,32,0,0,0,41,2020-03-11T20:00:00Z,41,0,0,8,2,10
2020-03-12,SC,10,48,0,0,0,58,2020-03-12T20:00:00Z,58,0,0,16,1,17
2020-03-13,SC,12,75,0,0,0,87,2020-03-13T20:00:00Z,87,0,0,27,2,29
2020-03-14,SC,13,110,0,0,0,123,2020-03-14T20:00:00Z,123,0,0,35,1,36
2020-03-15,SC,19,154,0,0,0,173,2020-03-15T20:00:00Z,173,0,0,44,6,50
2020-03-16,SC,28,235,0,0,1,263,2020-03-16T20:00:00Z,263,1,0,81,9,90
2020-03-17,SC,33,311,0,0,1,344,2020-03-17T20:00:00Z,344,0,0,76,5,81
2020-03-18,SC,60,583,0,0,1,643,2020-03-18T20:00:00Z,643,0,0,272,27,299
2020-03-19,SC,60,583,0,0,1,643,2020-03-19T20:00:00Z,643,0,0,0,0,0
2020-03-20,SC,81,833,0,0,1,914,2020-03-20T20:00:00Z,914,0,0,250,21,271
2020-03-21,SC,152,1255,0,0,1,1407,2020-03-21T20:00:00Z,1407,0,0,422,71,493
2020-03-22,SC,195,1466,0,0,3,1661,2020-03-22T20:00:00Z,1661,2,0,211,43,254
2020-03-23,SC,299,1466,0,0,5,1765,2020-03-23T20:00:00Z,1765,2,0,0,104,104
2020-03-24,SC,298,2012,0,0,5,2310,2020-03-24T20:00:00Z,2310,0,0,546,-1,545
2020-03-25,SC,424,2303,0,102,7,2727,2020-03-25T20:00:00Z,2727,2,102,291,126,417
2020-03-26,SC,456,2307,0,109,9,2763,2020-03-26T20:00:00Z,2763,2,7,4,32,36
2020-03-07,SD,0,5,0,0,0,5,2020-03-07T21:00:00Z,5,0,0,0,0,0
2020-03-08,SD,0,5,0,0,0,5,2020-03-08T20:00:00Z,5,0,0,0,0,0
2020-03-09,SD,0,5,0,0,0,5,2020-03-09T20:00:00Z,5,0,0,0,0,0
2020-03-10,SD,0,11,0,0,0,11,2020-03-10T20:00:00Z,11,0,0,6,0,6
2020-03-11,SD,5,13,2,0,0,20,2020-03-11T20:00:00Z,18,0,0,2,5,7
2020-03-12,SD,8,27,11,0,0,46,2020-03-12T20:00:00Z,35,0,0,14,3,17
2020-03-13,SD,9,73,11,0,0,93,2020-03-13T20:00:00Z,82,0,0,46,1,47
2020-03-14,SD,9,182,3,0,0,194,2020-03-14T20:00:00Z,191,0,0,109,0,109
2020-03-15,SD,9,327,6,0,0,342,2020-03-15T20:00:00Z,336,0,0,145,0,145
2020-03-16,SD,10,494,0,0,0,504,2020-03-16T20:00:00Z,504,0,0,167,1,168
2020-03-17,SD,11,551,35,0,0,597,2020-03-17T20:00:00Z,562,0,0,57,1,58
2020-03-18,SD,11,551,350,0,1,912,2020-03-18T20:00:00Z,562,1,0,0,0,0
2020-03-19,SD,11,551,385,0,1,947,2020-03-19T20:00:00Z,562,0,0,0,0,0
2020-03-20,SD,14,663,270,0,1,947,2020-03-20T20:00:00Z,677,0,0,112,3,115
2020-03-21,SD,14,691,268,0,1,973,2020-03-21T20:00:00Z,705,0,0,28,0,28
2020-03-22,SD,21,740,277,0,1,1038,2020-03-22T20:00:00Z,761,0,0,49,7,56
2020-03-23,SD,28,762,265,0,1,1055,2020-03-23T20:00:00Z,790,0,0,22,7,29
2020-03-24,SD,30,790,268,0,1,1088,2020-03-24T20:00:00Z,820,0,0,28,2,30
2020-03-25,SD,41,819,268,0,1,1128,2020-03-25T20:00:00Z,860,0,0,29,11,40
2020-03-26,SD,46,1973,125,0,1,2144,2020-03-26T20:00:00Z,2019,0,0,1154,5,1159
2020-03-05,TN,1,0,0,0,0,1,2020-03-05T21:00:00Z,1,0,0,0,0,0
2020-03-06,TN,1,0,0,0,0,1,2020-03-06T21:00:00Z,1,0,0,0,0,0
2020-03-07,TN,1,0,0,0,0,1,2020-03-07T21:00:00Z,1,0,0,0,0,0
2020-03-08,TN,3,0,0,0,0,3,2020-03-08T20:00:00Z,3,0,0,0,2,2
2020-03-09,TN,3,0,0,0,0,3,2020-03-09T20:00:00Z,3,0,0,0,0,0
2020-03-10,TN,7,0,0,0,0,7,2020-03-10T20:00:00Z,7,0,0,0,4,4
2020-03-11,TN,7,50,0,0,0,57,2020-03-11T20:00:00Z,57,0,0,50,0,50
2020-03-12,TN,18,79,0,0,0,97,2020-03-12T20:00:00Z,97,0,0,29,11,40
2020-03-13,TN,26,116,0,0,0,142,2020-03-13T20:00:00Z,142,0,0,37,8,45
2020-03-14,TN,32,130,0,0,0,162,2020-03-14T20:00:00Z,162,0,0,14,6,20
2020-03-15,TN,39,157,0,0,0,196,2020-03-15T20:00:00Z,196,0,0,27,7,34
2020-03-16,TN,52,270,0,0,0,322,2020-03-16T20:00:00Z,322,0,0,113,13,126
2020-03-17,TN,73,330,0,0,0,403,2020-03-17T20:00:00Z,403,0,0,60,21,81
2020-03-18,TN,98,349,0,0,0,447,2020-03-18T20:00:00Z,447,0,0,19,25,44
2020-03-19,TN,154,349,0,0,0,503,2020-03-19T20:00:00Z,503,0,0,0,56,56
2020-03-20,TN,228,563,0,0,0,791,2020-03-20T20:00:00Z,791,0,0,214,74,288
2020-03-21,TN,371,3272,0,0,0,3643,2020-03-21T20:00:00Z,3643,0,0,2709,143,2852
2020-03-22,TN,505,3272,0,0,0,3777,2020-03-22T20:00:00Z,3777,0,0,0,134,134
2020-03-23,TN,615,3272,0,0,2,3887,2020-03-23T20:00:00Z,3887,2,0,0,110,110
2020-03-24,TN,667,10517,0,0,2,11184,2020-03-24T20:00:00Z,11184,0,0,7245,52,7297
2020-03-25,TN,784,11012,0,53,3,11796,2020-03-25T20:00:00Z,11796,1,53,495,117,612
2020-03-26,TN,957,13952,0,76,3,14909,2020-03-26T20:00:00Z,14909,0,23,2940,173,3113
2020-03-04,TX,1,0,0,0,0,1,2020-03-04T21:00:00Z,1,0,0,0,0,0
2020-03-05,TX,1,0,0,0,0,1,2020-03-05T21:00:00Z,1,0,0,0,0,0
2020-03-06,TX,5,0,0,0,0,5,2020-03-06T21:00:00Z,5,0,0,0,4,4
2020-03-07,TX,8,0,0,0,0,8,2020-03-07T21:00:00Z,8,0,0,0,3,3
2020-03-08,TX,8,0,0,0,0,8,2020-03-08T20:00:00Z,8,0,0,0,0,0
2020-03-09,TX,12,0,0,0,0,12,2020-03-09T20:00:00Z,12,0,0,0,4,4
2020-03-10,TX,13,0,0,0,0,13,2020-03-10T20:00:00Z,13,0,0,0,1,1
2020-03-11,TX,21,0,0,0,0,21,2020-03-11T20:00:00Z,21,0,0,0,8,8
2020-03-12,TX,23,0,0,0,0,23,2020-03-12T20:00:00Z,23,0,0,0,2,2
2020-03-13,TX,39,0,0,0,0,39,2020-03-13T20:00:00Z,39,0,0,0,16,16
2020-03-14,TX,51,0,0,0,0,51,2020-03-14T20:00:00Z,51,0,0,0,12,12
2020-03-15,TX,56,0,0,0,0,56,2020-03-15T20:00:00Z,56,0,0,0,5,5
2020-03-16,TX,57,0,0,0,0,57,2020-03-16T20:00:00Z,57,0,0,0,1,1
2020-03-17,TX,64,1204,0,0,1,1268,2020-03-17T20:00:00Z,1268,1,0,1204,7,1211
2020-03-18,TX,83,1824,0,0,2,1907,2020-03-18T20:00:00Z,1907,1,0,620,19,639
2020-03-19,TX,143,2212,0,0,3,2355,2020-03-19T20:00:00Z,2355,1,0,388,60,448
2020-03-20,TX,194,5083,0,0,5,5277,2020-03-20T20:00:00Z,5277,2,0,2871,51,2922
2020-03-21,TX,304,6218,0,0,5,6522,2020-03-21T20:00:00Z,6522,0,0,1135,110,1245
2020-03-22,TX,334,8422,0,0,5,8756,2020-03-22T20:00:00Z,8756,0,0,2204,30,2234
2020-03-23,TX,352,9703,0,0,8,10055,2020-03-23T20:00:00Z,10055,3,0,1281,18,1299
2020-03-24,TX,410,10757,0,0,9,11167,2020-03-24T20:00:00Z,11167,1,0,1054,58,1112
2020-03-25,TX,974,12520,0,0,12,13494,2020-03-25T20:00:00Z,13494,3,0,1763,564,2327
2020-03-26,TX,1396,20028,0,0,18,21424,2020-03-26T20:00:00Z,21424,6,0,7508,422,7930
2020-03-07,UT,1,0,0,0,0,1,2020-03-07T21:00:00Z,1,0,0,0,0,0
2020-03-08,UT,1,0,0,0,0,1,2020-03-08T20:00:00Z,1,0,0,0,0,0
2020-03-09,UT,1,0,0,0,0,1,2020-03-09T20:00:00Z,1,0,0,0,0,0
2020-03-10,UT,2,0,0,0,0,2,2020-03-10T20:00:00Z,2,0,0,0,1,1
2020-03-11,UT,2,0,0,0,0,2,2020-03-11T20:00:00Z,2,0,0,0,0,0
2020-03-12,UT,4,131,0,0,0,135,2020-03-12T20:00:00Z,135,0,0,131,2,133
2020-03-13,UT,6,131,0,0,0,137,2020-03-13T20:00:00Z,137,0,0,0,2,2
2020-03-14,UT,6,131,0,0,0,137,2020-03-14T20:00:00Z,137,0,0,0,0,0
2020-03-15,UT,28,131,0,0,0,159,2020-03-15T20:00:00Z,159,0,0,0,22,22
2020-03-16,UT,39,131,0,0,0,170,2020-03-16T20:00:00Z,170,0,0,0,11,11
2020-03-17,UT,51,131,0,0,0,182,2020-03-17T20:00:00Z,182,0,0,0,12,12
2020-03-18,UT,63,131,0,0,0,194,2020-03-18T20:00:00Z,194,0,0,0,12,12
2020-03-19,UT,78,1448,0,0,0,1526,2020-03-19T20:00:00Z,1526,0,0,1317,15,1332
2020-03-20,UT,112,2035,0,0,0,2147,2020-03-20T20:00:00Z,2147,0,0,587,34,621
2020-03-21,UT,136,2424,0,0,0,2560,2020-03-21T20:00:00Z,2560,0,0,389,24,413
2020-03-22,UT,181,3508,0,0,1,3689,2020-03-22T20:00:00Z,3689,1,0,1084,45,1129
2020-03-23,UT,257,4790,0,0,1,5047,2020-03-23T20:00:00Z,5047,0,0,1282,76,1358
2020-03-24,UT,299,5524,0,0,1,5823,2020-03-24T20:00:00Z,5823,0,0,734,42,776
2020-03-25,UT,346,6491,0,0,1,6837,2020-03-25T20:00:00Z,6837,0,0,967,47,1014
2020-03-26,UT,402,7308,0,0,1,7710,2020-03-26T20:00:00Z,7710,0,0,817,56,873
2020-03-05,VA,0,18,3,0,0,21,2020-03-05T21:00:00Z,18,0,0,0,0,0
2020-03-06,VA,0,21,10,0,0,31,2020-03-06T21:00:00Z,21,0,0,3,0,3
2020-03-07,VA,0,31,7,0,0,38,2020-03-07T21:00:00Z,31,0,0,10,0,10
2020-03-08,VA,2,36,6,0,0,44,2020-03-08T20:00:00Z,38,0,0,5,2,7
2020-03-09,VA,3,38,9,0,0,50,2020-03-09T20:00:00Z,41,0,0,2,1,3
2020-03-10,VA,8,53,0,0,0,61,2020-03-10T20:00:00Z,61,0,0,15,5,20
2020-03-11,VA,9,60,0,0,0,69,2020-03-11T20:00:00Z,69,0,0,7,1,8
2020-03-12,VA,17,117,0,0,0,134,2020-03-12T20:00:00Z,134,0,0,57,8,65
2020-03-13,VA,30,117,0,0,0,147,2020-03-13T20:00:00Z,147,0,0,0,13,13
2020-03-14,VA,30,117,0,0,0,147,2020-03-14T20:00:00Z,147,0,0,0,0,0
2020-03-15,VA,45,363,0,0,1,408,2020-03-15T20:00:00Z,408,1,0,246,15,261
2020-03-16,VA,51,438,0,0,1,489,2020-03-16T20:00:00Z,489,0,0,75,6,81
2020-03-17,VA,67,961,0,0,1,1028,2020-03-17T20:00:00Z,1028,0,0,523,16,539
2020-03-18,VA,77,1201,0,0,1,1278,2020-03-18T20:00:00Z,1278,0,0,240,10,250
2020-03-19,VA,94,1829,0,0,2,1923,2020-03-19T20:00:00Z,1923,1,0,628,17,645
2020-03-20,VA,114,2211,0,0,2,2325,2020-03-20T20:00:00Z,2325,0,0,382,20,402
2020-03-21,VA,152,2638,0,25,2,2790,2020-03-21T20:00:00Z,2790,0,25,427,38,465
2020-03-22,VA,219,3118,0,32,3,3337,2020-03-22T20:00:00Z,3337,1,7,480,67,547
2020-03-23,VA,254,3443,0,38,6,3697,2020-03-23T20:00:00Z,3697,3,6,325,35,360
2020-03-24,VA,290,4180,0,45,7,4470,2020-03-24T20:00:00Z,4470,1,7,737,36,773
2020-03-25,VA,391,4979,0,59,9,5370,2020-03-25T20:00:00Z,5370,2,14,799,101,900
2020-03-26,VA,460,5729,0,65,13,6189,2020-03-26T20:00:00Z,6189,4,6,750,69,819
2020-03-16,VI,1,0,0,0,0,1,2020-03-16T20:00:00Z,1,0,0,0,0,0
2020-03-17,VI,2,0,0,0,0,2,2020-03-17T20:00:00Z,2,0,0,0,1,1
2020-03-18,VI,2,0,0,0,0,2,2020-03-18T20:00:00Z,2,0,0,0,0,0
2020-03-19,VI,3,0,0,0,0,3,2020-03-19T20:00:00Z,3,0,0,0,1,1
2020-03-20,VI,3,0,0,0,0,3,2020-03-20T20:00:00Z,3,0,0,0,0,0
2020-03-21,VI,6,0,0,0,0,6,2020-03-21T20:00:00Z,6,0,0,0,3,3
2020-03-22,VI,6,0,0,0,0,6,2020-03-22T20:00:00Z,6,0,0,0,0,0
2020-03-23,VI,17,0,0,0,0,17,2020-03-23T20:00:00Z,17,0,0,0,11,11
2020-03-24,VI,17,0,0,0,0,17,2020-03-24T20:00:00Z,17,0,0,0,0,0
2020-03-25,VI,17,55,2,0,0,74,2020-03-25T20:00:00Z,72,0,0,55,0,55
2020-03-26,VI,17,55,2,0,0,74,2020-03-26T20:00:00Z,72,0,0,0,0,0
2020-03-06,VT,0,8,0,0,0,8,2020-03-06T21:00:00Z,8,0,0,0,0,0
2020-03-07,VT,0,16,0,0,0,16,2020-03-07T21:00:00Z,16,0,0,8,0,8
2020-03-08,VT,1,28,0,0,0,29,2020-03-08T20:00:00Z,29,0,0,12,1,13
2020-03-09,VT,1,34,0,0,0,35,2020-03-09T20:00:00Z,35,0,0,6,0,6
2020-03-10,VT,1,40,0,0,0,41,2020-03-10T20:00:00Z,41,0,0,6,0,6
2020-03-11,VT,1,62,0,0,0,63,2020-03-11T20:00:00Z,63,0,0,22,0,22
2020-03-12,VT,2,97,0,0,0,99,2020-03-12T20:00:00Z,99,0,0,35,1,36
2020-03-13,VT,2,142,0,0,0,144,2020-03-13T20:00:00Z,144,0,0,45,0,45
2020-03-14,VT,4,227,0,0,0,231,2020-03-14T20:00:00Z,231,0,0,85,2,87
2020-03-15,VT,4,348,0,0,0,352,2020-03-15T20:00:00Z,352,0,0,121,0,121
2020-03-16,VT,8,421,0,0,0,429,2020-03-16T20:00:00Z,429,0,0,73,4,77
2020-03-17,VT,10,495,0,0,0,505,2020-03-17T20:00:00Z,505,0,0,74,2,76
2020-03-18,VT,19,592,0,0,0,611,2020-03-18T20:00:00Z,611,0,0,97,9,106
2020-03-19,VT,22,645,0,0,0,667,2020-03-19T20:00:00Z,667,0,0,53,3,56
2020-03-20,VT,29,779,0,0,2,808,2020-03-20T20:00:00Z,808,2,0,134,7,141
2020-03-21,VT,29,779,0,0,2,808,2020-03-21T20:00:00Z,808,0,0,0,0,0
2020-03-22,VT,52,1106,0,0,2,1158,2020-03-22T20:00:00Z,1158,0,0,327,23,350
2020-03-23,VT,75,1106,0,0,5,1181,2020-03-23T20:00:00Z,1181,3,0,0,23,23
2020-03-24,VT,95,1440,0,0,7,1535,2020-03-24T20:00:00Z,1535,2,0,334,20,354
2020-03-25,VT,123,1589,0,0,8,1712,2020-03-25T20:00:00Z,1712,1,0,149,28,177
2020-03-26,VT,158,1850,0,0,9,2008,2020-03-26T20:00:00Z,2008,1,0,261,35,296
2020-03-04,WA,39,0,0,0,0,39,2020-03-04T21:00:00Z,39,0,0,0,0,0
2020-03-05,WA,70,0,0,0,0,70,2020-03-05T21:00:00Z,70,0,0,0,31,31
2020-03-06,WA,79,370,0,0,0,449,2020-03-06T21:00:00Z,449,0,0,370,9,379
2020-03-07,WA,102,370,66,0,0,538,2020-03-07T21:00:00Z,472,0,0,0,23,23
2020-03-08,WA,102,640,60,0,0,802,2020-03-08T20:00:00Z,742,0,0,270,0,270
2020-03-09,WA,136,1110,0,0,0,1246,2020-03-09T20:00:00Z,1246,0,0,470,34,504
2020-03-10,WA,162,1110,0,0,0,1272,2020-03-10T20:00:00Z,1272,0,0,0,26,26
2020-03-11,WA,267,2175,0,0,24,2442,2020-03-11T20:00:00Z,2442,24,0,1065,105,1170
2020-03-12,WA,337,3037,0,0,29,3374,2020-03-12T20:00:00Z,3374,5,0,862,70,932
2020-03-13,WA,457,4350,0,0,31,4807,2020-03-13T20:00:00Z,4807,2,0,1313,120,1433
2020-03-14,WA,568,6001,0,0,37,6569,2020-03-14T20:00:00Z,6569,6,0,1651,111,1762
2020-03-15,WA,642,7122,0,0,40,7764,2020-03-15T20:00:00Z,7764,3,0,1121,74,1195
2020-03-16,WA,769,9451,0,0,42,10220,2020-03-16T20:00:00Z,10220,2,0,2329,127,2456
2020-03-17,WA,904,11582,0,0,48,12486,2020-03-17T20:00:00Z,12486,6,0,2131,135,2266
2020-03-18,WA,1012,13117,0,0,52,14129,2020-03-18T20:00:00Z,14129,4,0,1535,108,1643
2020-03-19,WA,1187,15918,0,0,66,17105,2020-03-19T20:00:00Z,17105,14,0,2801,175,2976
2020-03-20,WA,1376,19336,0,0,74,20712,2020-03-20T20:00:00Z,20712,8,0,3418,189,3607
2020-03-21,WA,1524,21719,0,0,83,23243,2020-03-21T20:00:00Z,23243,9,0,2383,148,2531
2020-03-22,WA,1793,25328,0,0,94,27121,2020-03-22T20:00:00Z,27121,11,0,3609,269,3878
2020-03-23,WA,1996,28879,0,0,95,30875,2020-03-23T20:00:00Z,30875,1,0,3551,203,3754
2020-03-24,WA,2221,31712,0,0,110,33933,2020-03-24T20:00:00Z,33933,15,0,2833,225,3058
2020-03-25,WA,2469,31712,0,0,123,34181,2020-03-25T20:00:00Z,34181,13,0,0,248,248
2020-03-26,WA,2580,31712,0,0,132,34292,2020-03-26T20:00:00Z,34292,9,0,0,111,111
2020-03-04,WI,1,19,6,0,0,26,2020-03-04T21:00:00Z,20,0,0,0,0,0
2020-03-05,WI,1,19,6,0,0,26,2020-03-05T21:00:00Z,20,0,0,0,0,0
2020-03-06,WI,1,31,12,0,0,44,2020-03-06T21:00:00Z,32,0,0,12,0,12
2020-03-07,WI,1,31,12,0,0,44,2020-03-07T21:00:00Z,32,0,0,0,0,0
2020-03-08,WI,1,31,12,0,0,44,2020-03-08T20:00:00Z,32,0,0,0,0,0
2020-03-09,WI,1,36,0,0,0,37,2020-03-09T20:00:00Z,37,0,0,5,0,5
2020-03-10,WI,2,36,0,0,0,38,2020-03-10T20:00:00Z,38,0,0,0,1,1
2020-03-11,WI,3,43,0,0,0,46,2020-03-11T20:00:00Z,46,0,0,7,1,8
2020-03-12,WI,8,84,0,0,0,92,2020-03-12T20:00:00Z,92,0,0,41,5,46
2020-03-13,WI,19,169,0,0,0,188,2020-03-13T20:00:00Z,188,0,0,85,11,96
2020-03-14,WI,19,169,0,0,0,188,2020-03-14T20:00:00Z,188,0,0,0,0,0
2020-03-15,WI,33,313,0,0,0,346,2020-03-15T20:00:00Z,346,0,0,144,14,158
2020-03-16,WI,47,504,0,0,0,551,2020-03-16T20:00:00Z,551,0,0,191,14,205
2020-03-17,WI,72,1038,0,0,0,1110,2020-03-17T20:00:00Z,1110,0,0,534,25,559
2020-03-18,WI,106,1577,0,0,0,1683,2020-03-18T20:00:00Z,1683,0,0,539,34,573
2020-03-19,WI,155,2192,0,0,0,2347,2020-03-19T20:00:00Z,2347,0,0,615,49,664
2020-03-20,WI,206,3455,0,0,3,3661,2020-03-20T20:00:00Z,3661,3,0,1263,51,1314
2020-03-21,WI,281,4628,0,0,4,4909,2020-03-21T20:00:00Z,4909,1,0,1173,75,1248
2020-03-22,WI,385,6230,0,0,4,6615,2020-03-22T20:00:00Z,6615,0,0,1602,104,1706
2020-03-23,WI,416,7050,0,0,5,7466,2020-03-23T20:00:00Z,7466,1,0,820,31,851
2020-03-24,WI,457,8237,0,0,5,8694,2020-03-24T20:00:00Z,8694,0,0,1187,41,1228
2020-03-25,WI,585,10089,0,0,7,10674,2020-03-25T20:00:00Z,10674,2,0,1852,128,1980
2020-03-26,WI,707,11583,0,0,8,12290,2020-03-26T20:00:00Z,12290,1,0,1494,122,1616
2020-03-06,WV,0,1,4,0,0,5,2020-03-06T21:00:00Z,1,0,0,0,0,0
2020-03-07,WV,0,2,3,0,0,5,2020-03-07T21:00:00Z,2,0,0,1,0,1
2020-03-08,WV,0,2,3,0,0,5,2020-03-08T20:00:00Z,2,0,0,0,0,0
2020-03-09,WV,0,2,3,0,0,5,2020-03-09T20:00:00Z,2,0,0,0,0,0
2020-03-10,WV,0,2,3,0,0,5,2020-03-10T20:00:00Z,2,0,0,0,0,0
2020-03-11,WV,0,3,2,0,0,5,2020-03-11T20:00:00Z,3,0,0,1,0,1
2020-03-12,WV,0,7,1,0,0,8,2020-03-12T20:00:00Z,7,0,0,4,0,4
2020-03-13,WV,0,17,4,0,0,21,2020-03-13T20:00:00Z,17,0,0,10,0,10
2020-03-14,WV,0,26,5,0,0,31,2020-03-14T20:00:00Z,26,0,0,9,0,9
2020-03-15,WV,0,38,1,0,0,39,2020-03-15T20:00:00Z,38,0,0,12,0,12
2020-03-16,WV,0,80,4,0,0,84,2020-03-16T20:00:00Z,80,0,0,42,0,42
2020-03-17,WV,0,80,4,0,0,84,2020-03-17T20:00:00Z,80,0,0,0,0,0
2020-03-18,WV,1,122,14,0,0,137,2020-03-18T20:00:00Z,123,0,0,42,1,43
2020-03-19,WV,2,143,3,0,0,148,2020-03-19T20:00:00Z,145,0,0,21,1,22
2020-03-20,WV,7,219,13,0,0,239,2020-03-20T20:00:00Z,226,0,0,76,5,81
2020-03-21,WV,11,330,2,1,0,343,2020-03-21T20:00:00Z,341,0,1,111,4,115
2020-03-22,WV,12,385,1,1,0,398,2020-03-22T20:00:00Z,397,0,0,55,1,56
2020-03-23,WV,16,444,4,1,0,464,2020-03-23T20:00:00Z,460,0,0,59,4,63
2020-03-24,WV,20,610,0,1,0,630,2020-03-24T20:00:00Z,630,0,0,166,4,170
2020-03-25,WV,39,759,6,1,0,804,2020-03-25T20:00:00Z,798,0,0,149,19,168
2020-03-26,WV,51,1031,19,1,0,1101,2020-03-26T20:00:00Z,1082,0,0,272,12,284
2020-03-07,WY,0,0,0,0,0,0,2020-03-07T21:00:00Z,0,0,0,0,0,0
2020-03-08,WY,0,0,0,0,0,0,2020-03-08T20:00:00Z,0,0,0,0,0,0
2020-03-09,WY,0,0,0,0,0,0,2020-03-09T20:00:00Z,0,0,0,0,0,0
2020-03-10,WY,0,0,0,0,0,0,2020-03-10T20:00:00Z,0,0,0,0,0,0
2020-03-11,WY,0,0,0,0,0,0,2020-03-11T20:00:00Z,0,0,0,0,0,0
2020-03-12,WY,1,0,0,0,0,1,2020-03-12T20:00:00Z,1,0,0,0,1,1
2020-03-13,WY,1,0,0,0,0,1,2020-03-13T20:00:00Z,1,0,0,0,0,0
2020-03-14,WY,2,0,0,0,0,2,2020-03-14T20:00:00Z,2,0,0,0,1,1
2020-03-15,WY,3,0,0,0,0,3,2020-03-15T20:00:00Z,3,0,0,0,1,1
2020-03-16,WY,3,0,0,0,0,3,2020-03-16T20:00:00Z,3,0,0,0,0,0
2020-03-17,WY,10,95,0,0,0,105,2020-03-17T20:00:00Z,105,0,0,95,7,102
2020-03-18,WY,15,178,0,0,0,193,2020-03-18T20:00:00Z,193,0,0,83,5,88
2020-03-19,WY,18,271,0,0,0,289,2020-03-19T20:00:00Z,289,0,0,93,3,96
2020-03-20,WY,19,331,0,0,0,350,2020-03-20T20:00:00Z,350,0,0,60,1,61
2020-03-21,WY,23,438,0,0,0,461,2020-03-21T20:00:00Z,461,0,0,107,4,111
2020-03-22,WY,24,438,0,0,0,462,2020-03-22T20:00:00Z,462,0,0,0,1,1
2020-03-23,WY,26,592,0,0,0,618,2020-03-23T20:00:00Z,618,0,0,154,2,156
2020-03-24,WY,29,710,0,0,0,739,2020-03-24T20:00:00Z,739,0,0,118,3,121
2020-03-25,WY,44,954,0,0,0,998,2020-03-25T20:00:00Z,998,0,0,244,15,259
2020-03-26,WY,53,1052,0,0,0,1105,2020-03-26T20:00:00Z,1105,0,0,98,9,107
